junction	junction_aa	v_call	j_call
TGTGCCACCAGTGGAGCTGACCCCACTGAAGCTTTCTTT	CATSGADPTEAFF	TRBV24-1	TRBJ1-1
TGTGCCAGCAGTCCAACAAGAGGGGGAACTCACTACGAGCAGTACTTC	CASSPTRGGTHYEQYF	TRBV27	TRBJ2-7
TGTGCCAGCAGGGGGCTTAAGATTAAGACTAGCGGGGTTACCGGGGAGCTGTTTTTT	CASRGLKIKTSGVTGELFF	TRBV6-1	TRBJ2-2
TGTGCCAGCAGCCTTCCCCCAGGGGACTACGAGCAGTACTTC	CASSLPPGDYEQYF	TRBV7-2	TRBJ2-7
TGTGCCAGTTCGTCAGGGACGGGAGGGGCCAACGTCCTGACTTTC	CASSSGTGGANVLTF	TRBV19	TRBJ2-6
TGCGCCAGCAGTGAGCCCCAGGGGGGCCGAAACACCATATATTTT	CASSEPQGGRNTIYF	TRBV10-1	TRBJ1-3
TGCGCCAGCAGCGACCAGGGTTCGACCTGGTTACCTGGCTACACCTTC	CASSDQGSTWLPGYTF	TRBV5-1	TRBJ1-2
TGTGCCCAGCGTAGAGTTACTAGTCCCGAAAAACTGTTTTTT	CAQRRVTSPEKLFF	TRBV10-3	TRBJ1-4
TGCAGCGTAGGACAGGGTTCACCCCTCCACTTT	CSVGQGSPLHF	TRBV29-1	TRBJ1-6
TGTGCCAGCAGGCCCTCATTCCGGGACAGGGTGTCCTATGGCTACACCTTC	CASRPSFRDRVSYGYTF	TRBV11-2	TRBJ1-2
TGCGCCAGCAGTCGCGGCAACGAGACCCAGTACTTC	CASSRGNETQYF	TRBV10-1	TRBJ2-5
TGTGCCAGCAGCAACTTCCCCCGACTAGGTAAGCTGCTAGCCAAAAACATTCAGTACTTC	CASSNFPRLGKLLAKNIQYF	TRBV7-4	TRBJ2-4
TGTGCCAGCAGCTATCCCTGGACAGGGGCCTACGAGCAGTACTTC	CASSYPWTGAYEQYF	TRBV11-2	TRBJ2-7
TGTGCCAGCAGCCAAGCCCAGCGAGATGGCTACACCTTC	CASSQAQRDGYTF	TRBV4-2	TRBJ1-2
TGTGCCAGCAGTCCTCTGGGACAGGGGTTGGGAGATACGCAGTATTTT	CASSPLGQGLGDTQYF	TRBV27	TRBJ2-3
TGTGCCAGCAGTGAGACCAACGCGCAGATGGAGATCTTC	CASSETNAQMEIF	TRBV2	TRBJ1-2
TGCAGTGCTTTCCCCTTTGGGGCTGCGCGCGTAAATGAAAAACTGTTTTTT	CSAFPFGAARVNEKLFF	TRBV20-1	TRBJ1-4
TGTGCCAGCAGCTTAACCCGGGGGCGGGACAGGGGCGAGCAGTACTTC	CASSLTRGRDRGEQYF	TRBV7-7	TRBJ2-7
TGTGCCAGCAGTTATTCGAGGTACGAGCAGTACTTC	CASSYSRYEQYF	TRBV6-6	TRBJ2-7
TGCGCCAGCAGCTTGGACTTCCCAACTAGCGGAGATCGAGGGCAAGAGACCCAGTACTTC	CASSLDFPTSGDRGQETQYF	TRBV5-1	TRBJ2-5
TGCGCCAGCCCAAATTGGGGAACCCAAGAGACCCAGTACTTC	CASPNWGTQETQYF	TRBV10-1	TRBJ2-5
TGCGCCAGCAGCGTTGGGAGGCCCGGGACGTCGAACACTGAAGCTTTCTTT	CASSVGRPGTSNTEAFF	TRBV5-1	TRBJ1-1
TGCGCCAGCAGCTTGGCTACAAATCAGCCCCAGCATTTT	CASSLATNQPQHF	TRBV5-1	TRBJ1-5
TGTGCCAGCAGCTCCTCCAGGTATTCGGGATATCGTAGTCAGCCCCAGCATTTT	CASSSSRYSGYRSQPQHF	TRBV11-3	TRBJ1-5
TGTGCCAGCAGGGTCAGGTTTAGTGAGCAGTTCTTC	CASRVRFSEQFF	TRBV7-9	TRBJ2-1
TGTGCCAGCTACGGGAGGGGCTACACCTTC	CASYGRGYTF	TRBV27	TRBJ1-2
TGTGCCAGCAGCTTAGTGTGGACAGGGGGCCAGGGAGGGGTCTATGGCTACACCTTC	CASSLVWTGGQGGVYGYTF	TRBV7-6	TRBJ1-2
TGCAGTGCTAGCGAGACAGGTTTAACGCAGTTCTTC	CSASETGLTQFF	TRBV20-1	TRBJ2-1
TGTGCCAGCCCGGGGGGGCTTACCTACGAGCAGTACTTC	CASPGGLTYEQYF	TRBV27	TRBJ2-7
TGCGCCAGCAGCCTAGGGGGGGCCCGCAACTACGAGCAGTACTTC	CASSLGGARNYEQYF	TRBV5-1	TRBJ2-7
TGTGCCACCAGTGCCCCCCCCGCTAACAGGGACGAGCAGTACTTC	CATSAPPANRDEQYF	TRBV24-1	TRBJ2-7
TGTGCCAGCAGCATAATTTACTCGCCAGGGGGCGTCGACACTGAAGCTTTCTTT	CASSIIYSPGGVDTEAFF	TRBV9	TRBJ1-1
TGTGCCAGCAGTTTGAAACAGGGTCGGGGAAACACCATATATTTT	CASSLKQGRGNTIYF	TRBV12-4	TRBJ1-3
TGTGCCAGCAGCGTCCCCGGTGGGGCCCACGAACTTCCGCTGAGGCAGTACTTC	CASSVPGGAHELPLRQYF	TRBV11-2	TRBJ2-7
TGTGCCAGCAGCCGGGGGCGGGACATCCCCGGAGCCAAAAACATTCAGTACTTC	CASSRGRDIPGAKNIQYF	TRBV3-1	TRBJ2-4
TGTGCCAGCAGTGACTCGTTCCGACGACCGGGACTAGCGGGTCCCTACGACAATGAGCAGTTCTTC	CASSDSFRRPGLAGPYDNEQFF	TRBV6-4	TRBJ2-1
TGCGCCAGCAGCTTGAAAATTATGAATCACACCAGCAACCCTCATAGCAATCAGCCCCAGCATTTT	CASSLKIMNHTSNPHSNQPQHF	TRBV5-1	TRBJ1-5
TGTGCCATCAGTCAAGGGGGGAGAGAGACCCAGTACTTC	CAISQGGRETQYF	TRBV10-3	TRBJ2-5
TGTGCCAGCATTTTACAAAAGGAGCGACGAGTACACGAGCAGTACTTC	CASILQKERRVHEQYF	TRBV6-4	TRBJ2-7
TGCGCCAGCAGCTCGGGAAGGCGGGAGACCAAGACGCAGTATTTT	CASSSGRRETKTQYF	TRBV5-1	TRBJ2-3
TGTGCCAGCAGTGAACCGACTCGACATGGAAACACCATATATTTT	CASSEPTRHGNTIYF	TRBV6-1	TRBJ1-3
TGTGCCACCGGCACAGAGGGGAATCAGCCCCAGCATTTT	CATGTEGNQPQHF	TRBV10-3	TRBJ1-5
TGCGCCAGCAGCTTGGAAATTACAGGGGGTAGAAGTCGGTTCTACGAGCAGTACTTC	CASSLEITGGRSRFYEQYF	TRBV5-1	TRBJ2-7
TGTGCCAGCAGCTTAAGTTATGGAAAAAGCTCCTATAATTCACCCCTCCACTTT	CASSLSYGKSSYNSPLHF	TRBV7-3	TRBJ1-6
TGTGCCAGTCGGGGGATGGGACAGTCGACTGAAGCTTTCTTT	CASRGMGQSTEAFF	TRBV27	TRBJ1-1
TGTGCCAGCAGGTACCGGGGGCGAGTTTACCCCTACGAGCAGTACTTC	CASRYRGRVYPYEQYF	TRBV6-4	TRBJ2-7
TGTGCTAGTGGTTTGGTACCCCCACTAGCGGGAGAAGGGGAGCTGTTTTTT	CASGLVPPLAGEGELFF	TRBV12-5	TRBJ2-2
TGTGCCAGCAGGTACAAACGCTACGAGCAGTACTTC	CASRYKRYEQYF	TRBV6-6	TRBJ2-7
TGTGCCAGCAGCTTCCTGAGGCGGACCGCCAAAAACATTCAGTACTTC	CASSFLRRTAKNIQYF	TRBV7-3	TRBJ2-4
TGTGCCAGCAGCGGGGAGTGGGGGCAGTACTTC	CASSGEWGQYF	TRBV7-4	TRBJ2-7
TGTGCCAGCAGCCATCCAGATGATACGCAGTATTTT	CASSHPDDTQYF	TRBV9	TRBJ2-3
TGCGCCAGCAGCTTGGTGAACCCCTCAAGACAACAGAATACTGAAGCTTTCTTT	CASSLVNPSRQQNTEAFF	TRBV5-1	TRBJ1-1
TGTGCCAGTAGTATACAGAGACTAGCCGGGGAGCTGTTTTTT	CASSIQRLAGELFF	TRBV19	TRBJ2-2
TGTGCCAGCAGACTCTGGGGCCGGAATTCACCCCTCCACTTT	CASRLWGRNSPLHF	TRBV27	TRBJ1-6
TGTGCCAGCAGCCCATTCCAAGGCACGTGTGGGGCCAACGTCCTGACTTTC	CASSPFQGTCGANVLTF	TRBV11-2	TRBJ2-6
TGTGCCAGCAGCAGGGACCAGGGTAATCAGCCCCAGCATTTT	CASSRDQGNQPQHF	TRBV7-2	TRBJ1-5
TGTGCCAGCAGATCCAGGGGAAGTGCCTACGAGCAGTACTTC	CASRSRGSAYEQYF	TRBV28	TRBJ2-7
TGCAGTGCTGTGGCATATCTAGCCACAGATACGCAGTATTTT	CSAVAYLATDTQYF	TRBV20-1	TRBJ2-3
TGCAGTGCTCGTGTTGGGGGGGGGAGGGGATTGAACACCGGGGAGCTGTTTTTT	CSARVGGGRGLNTGELFF	TRBV20-1	TRBJ2-2
TGTGCCAGCATACACCAGGGGGCCGGGACGACTAGGGTAGGCTGCGGTATCTACGAGCAGTACTTC	CASIHQGAGTTRVGCGIYEQYF	TRBV25-1	TRBJ2-7
TGTGCCAGCAGCCCCGGCTGGAAGCAAGAGACCCAGTACTTC	CASSPGWKQETQYF	TRBV13	TRBJ2-5
TGTGCCAGCAGCTCCCCGACAGGGGAATACGAGCAGTACTTC	CASSSPTGEYEQYF	TRBV13	TRBJ2-7
TGTGCCAGCAGCCACGTTCCTACTTTCGGTGCCTACGAGCAGTACTTC	CASSHVPTFGAYEQYF	TRBV4-2	TRBJ2-7
TGTGCCACCAGCAGAGATATAACCAGGGCCGGGCAGTACTTC	CATSRDITRAGQYF	TRBV15	TRBJ2-7
TGTGCCAGCAGCCAAGATTATAACCGGGAGGGGCGCTACGAGCAGTACTTC	CASSQDYNREGRYEQYF	TRBV14	TRBJ2-7
TGTGCCAGCAGCGCGAGGACAGGGGGGGAGCAGCCCCAGCATTTT	CASSARTGGEQPQHF	TRBV7-3	TRBJ1-5
TGCGCCAGCAGAAGACACCGGGACATTGGCACCGGGGAGCTGTTTTTT	CASRRHRDIGTGELFF	TRBV5-1	TRBJ2-2
TGCAGTGCTAGAGATCTCGAACAGGGGGCGGGAAAGAACACTGAAGCTTTCTTT	CSARDLEQGAGKNTEAFF	TRBV20-1	TRBJ1-1
TGTGCCAGCAGCGTAGAGGCCAGACTGGATACGCAGTATTTT	CASSVEARLDTQYF	TRBV9	TRBJ2-3
TGTGCCAGCAGCAACCTGACTAGGACCCAGTACTTC	CASSNLTRTQYF	TRBV7-3	TRBJ2-5
TGTGCCCACGAGAATGAGCAGTTCTTC	CAHENEQFF	TRBV14	TRBJ2-1
TGTGCCAGCAGCTTCCTCCACGCCCACGATCAAGAGACCCAGTACTTC	CASSFLHAHDQETQYF	TRBV7-7	TRBJ2-5
TGTGCCACCAGCAGAGGCAAACGGGAGAAGAGGAATTCTGAAGGTAACTATGGCTACACCTTC	CATSRGKREKRNSEGNYGYTF	TRBV15	TRBJ1-2
TGTGCCAGTCCTGGTGGTCCGTATCAGGGACTAGCGGAGGAACCCAATGAGCAGTTCTTC	CASPGGPYQGLAEEPNEQFF	TRBV27	TRBJ2-1
TGTGCCAGCAGCGACTTGGTTTTGGAGACCCAGTACTTC	CASSDLVLETQYF	TRBV9	TRBJ2-5
TGCGCCAGCAGCCAAGATGGGGACCACCAGGAGCAGTTCTTC	CASSQDGDHQEQFF	TRBV4-3	TRBJ2-1
TGTGCCAGCAGCGCGGGCCTGGGGGGGGGACCCTACAATGAGCAGTTCTTC	CASSAGLGGGPYNEQFF	TRBV2	TRBJ2-1
TGTGCCAGTAGTTGGTCCGAGTTGGGTGAGCAGTTCTTC	CASSWSELGEQFF	TRBV19	TRBJ2-1
TGTGCCAGAGGACGTGACACTGAAGCTTTCTTT	CARGRDTEAFF	TRBV11-3	TRBJ1-1
TGTGCCAGCAGCTTAATTAACCCGGTCCGAGAACATGGCACTGAAGCTTTCTTT	CASSLINPVREHGTEAFF	TRBV11-1	TRBJ1-1
TGCAGTGCTAGAGAGGTTCGACACCTAGCGGGAATGACGAATAGCACAGATACGCAGTATTTT	CSAREVRHLAGMTNSTDTQYF	TRBV20-1	TRBJ2-3
TGTGCCAGCATGTCCCTACTAGGACAGGGGGCACTCTACGAGCAGTACTTC	CASMSLLGQGALYEQYF	TRBV30	TRBJ2-7
TGTGCCAGCATGGGACAGGGGAAGGCCCTCCACTTT	CASMGQGKALHF	TRBV6-1	TRBJ1-6
TGTGCCAGCAGAGGGGGGGACGTGTACACTGAAGCTTTCTTT	CASRGGDVYTEAFF	TRBV5-6	TRBJ1-1
TGTGCCAGCAGTATCCCGGCTCCTTCCACACGCGGGAGAGAAGTCTACGAGCAGTACTTC	CASSIPAPSTRGREVYEQYF	TRBV27	TRBJ2-7
TGTGCCAGCAGCTTAACGCCTCCCCGTAGACTCGGGTACAATGAGCAGTTCTTC	CASSLTPPRRLGYNEQFF	TRBV7-3	TRBJ2-1
TGTGCCAGCAGTTACCCCAGGGGCTCCTACGAGCAGTACTTC	CASSYPRGSYEQYF	TRBV6-6	TRBJ2-7
TGTGCCAGCAGTGCGGGAGTCCAAGACCAAGAGACCCAGTACTTC	CASSAGVQDQETQYF	TRBV6-5	TRBJ2-5
TGTGCCAGCAGCACAAGACCAGGGCTAAGCACAGATACGCAGTATTTT	CASSTRPGLSTDTQYF	TRBV7-9	TRBJ2-3
TGTGCCAGCAGCCCTAACCGGACAGACACTGAAGCTTTCTTT	CASSPNRTDTEAFF	TRBV6-2	TRBJ1-1
TGTGCCAGCAGCGATCCCCGTGGCGAGCAGTACTTC	CASSDPRGEQYF	TRBV11-2	TRBJ2-7
TGTGCCAGCGCCGAGAGCATCGGTGCAACTAATGAAAAACTGTTTTTT	CASAESIGATNEKLFF	TRBV4-2	TRBJ1-4
TGTGCCTGGAGGAACCGGGACAGGGCGCCTGGAAACACCATATATTTT	CAWRNRDRAPGNTIYF	TRBV30	TRBJ1-3
TGTGCCAGCAGCCCAGCGGGAGAATACTACGAGCAGTACTTC	CASSPAGEYYEQYF	TRBV13	TRBJ2-7
TGCAGCGTTGAAGGGGGGGCCGAAAACAATGAGCAGTTCTTC	CSVEGGAENNEQFF	TRBV29-1	TRBJ2-1
TGTGCCAGCAGCTTAGTTTTGGAGACAAAGGCTGAAGCTTTCTTT	CASSLVLETKAEAFF	TRBV7-9	TRBJ1-1
TGTGCCCGGGGGTGGGAGCCTAACTATGGCTACACCTTC	CARGWEPNYGYTF	TRBV6-4	TRBJ1-2
TGCGCCAGCAGCCCGACTAGCTGCACAGATACGCAGTATTTT	CASSPTSCTDTQYF	TRBV10-2	TRBJ2-3
TGTGCCAGCAGCGTCCAGTCCTACAATGAGCAGTTCTTC	CASSVQSYNEQFF	TRBV7-3	TRBJ2-1
TGTGCCAGCAGCGGGTGGGGCAGGGCCTACGAGCAGTACTTC	CASSGWGRAYEQYF	TRBV13	TRBJ2-7
TGTGCCAGCAGCAAGAGGGAGGTAGAGACCCAGTACTTC	CASSKREVETQYF	TRBV7-3	TRBJ2-5
TGTGCCAGCAGCGCTGGAGACAGGAATATGAACACTGAAGCTTTCTTT	CASSAGDRNMNTEAFF	TRBV7-3	TRBJ1-1
TGTGCCAGCTCACCACCTTTGACGGGACAGGGAGGGGAGCAGTACTTC	CASSPPLTGQGGEQYF	TRBV18	TRBJ2-7
TGCAGTGCTAGAGGGGCCGGGACAGGGGGCTGCGGCTACACCTTC	CSARGAGTGGCGYTF	TRBV20-1	TRBJ1-2
TGCAGTGCTAGAGTGCGAGGGGACAGGGCGCCGTCGAACACCGGGGAGCTGTTTTTT	CSARVRGDRAPSNTGELFF	TRBV20-1	TRBJ2-2
TGTGCCAGCAGCTTAGTGAAAATCGGACGTATCATAACAGATACGCAGTATTTT	CASSLVKIGRIITDTQYF	TRBV11-2	TRBJ2-3
TGTGCCAGCAGCTTAGCGGCCCGCTATAACAGGTACTTC	CASSLAARYNRYF	TRBV7-4	TRBJ2-7
TGCAGTGCTAGATACCAGGGGGAGTACATTCAGTACTTC	CSARYQGEYIQYF	TRBV20-1	TRBJ2-4
TGTGCCAGCAGTGACGGCGGGGTGGATACGCAGTTCTTC	CASSDGGVDTQFF	TRBV6-1	TRBJ2-1
TGTGCCAGCAGCACCCCACAGGGGGCAGTGGGTCAGCCCCAGCATTTT	CASSTPQGAVGQPQHF	TRBV7-4	TRBJ1-5
TGTGCCAGCAGCTTAGACCCAAGGGAGACCCAGTACTTC	CASSLDPRETQYF	TRBV7-2	TRBJ2-5
TGCAGTGCTAGAGATACCCCCCAGCGGGAAACTCTCCGAAACACCATATATTTT	CSARDTPQRETLRNTIYF	TRBV20-1	TRBJ1-3
TGTGCCACCAGAGAGACAGGGTTCCCCGGCTACACCTTC	CATRETGFPGYTF	TRBV24-1	TRBJ1-2
TGCGCCAGCCCGGGACAGGGGTCGAACACTGAAGCTTTCTTT	CASPGQGSNTEAFF	TRBV10-2	TRBJ1-1
TGTGCCAGAACAAGGGGGGTTTGGGCAAATTCACCCCTCCACTTT	CARTRGVWANSPLHF	TRBV6-4	TRBJ1-6
TGTGCCAGCAGTTCCAGGGACAGGGTACACGAGCAGTACTTC	CASSSRDRVHEQYF	TRBV11-2	TRBJ2-7
TGTGCCACCCCTGTGTTGGGGGCCCCGGCAGATACGCAGTATTTT	CATPVLGAPADTQYF	TRBV24-1	TRBJ2-3
TGCGCCAGCGGGACCGGGGAGTACAATGAGCAGTTCTTC	CASGTGEYNEQFF	TRBV10-1	TRBJ2-1
TGTGCCAGCAGTTATAAGCCATCGAGCCACCTTACATACAATGAGCAGTTCTTC	CASSYKPSSHLTYNEQFF	TRBV6-5	TRBJ2-1
TGTGCCAGCAGCTTCCCGAAACTAGCGGGAGCTGCTTTTCATCAGCCCCAGCATTTT	CASSFPKLAGAAFHQPQHF	TRBV7-2	TRBJ1-5
TGTGCCAGCAGCTGCCCCGGGACAGGGCTCACTGAAGCTTTCTTT	CASSCPGTGLTEAFF	TRBV7-9	TRBJ1-1
TGTGCCAGCAGTTACCCCCGACCTTTTAGGGGGTTTGAAAAACTGTTTTTT	CASSYPRPFRGFEKLFF	TRBV6-3	TRBJ1-4
TGTGCCAGCGAGCGGGACAGGGCAAGTAACTATGGCTACACCTTC	CASERDRASNYGYTF	TRBV19	TRBJ1-2
TGTGCCAGCAGTCGTTTTCAGGGGCCTGGTGTCTATGGCTACACCTTC	CASSRFQGPGVYGYTF	TRBV6-4	TRBJ1-2
TGCAGTGCTAGAGCCCGCGGGGACATGGGATTCTCTGGAAACACCATATATTTT	CSARARGDMGFSGNTIYF	TRBV20-1	TRBJ1-3
TGTGCCAGCAGCCAAGAGTCGGGGGGGGAGCTGTTTTTT	CASSQESGGELFF	TRBV3-1	TRBJ2-2
TGCGCCAGCAGTGACACAGGGGGCGCCACTGAAGCTTTCTTT	CASSDTGGATEAFF	TRBV10-1	TRBJ1-1
TGTGCCAGCAGACTCTACGAGCAGTACTTC	CASRLYEQYF	TRBV27	TRBJ2-7
TGTGCCAGCAGCGTAGATGGCCGGGACGAGGCGGACACCGGGGAGCTGTTTTTT	CASSVDGRDEADTGELFF	TRBV9	TRBJ2-2
TGTGCCAGCAGCGTAGACGTCGGGACAGGGGCGAGGAGCTCCGCTTTCTTT	CASSVDVGTGARSSAFF	TRBV9	TRBJ1-1
TGCAGTGCTAGAGGACAGGAGACTGAGCAGTTCTTC	CSARGQETEQFF	TRBV20-1	TRBJ2-1
TGTGCCAGCCCCCGGGGGTACCAGCCCCAGCATTTT	CASPRGYQPQHF	TRBV6-4	TRBJ1-5
TGTGCCAGCAGCTTAGCGACTAGAGTTGATGAGACCCAGTACTTC	CASSLATRVDETQYF	TRBV5-6	TRBJ2-5
TGTGCCACCCACTGTAAGGAAAAACTGTTTTTT	CATHCKEKLFF	TRBV27	TRBJ1-4
TGTGCCAGCAGCTTAGGTAGACAGCAATTGGACAATGAGCAGTTCTTC	CASSLGRQQLDNEQFF	TRBV7-2	TRBJ2-1
TGTGCCAGCAGCGTAGCCTATGAAAGGAGGGGGGCGAATGAGCAGTTCTTC	CASSVAYERRGANEQFF	TRBV9	TRBJ2-1
TGTGCCAGCAGCGGGTCTCCTCAGGGCTACAATGAGCAGTTCTTC	CASSGSPQGYNEQFF	TRBV11-3	TRBJ2-1
TGTGCCAGCAGTTCGGGGGCGCGTGCCTACAATGAGCAGTTCTTC	CASSSGARAYNEQFF	TRBV27	TRBJ2-1
TGTGCCAGCAGCCAAGCCGGGGTAAATGGCTACACCTTC	CASSQAGVNGYTF	TRBV3-1	TRBJ1-2
TGTGCCAGCACAGGGGAGGGGGGGGAGCTGTTTTTT	CASTGEGGELFF	TRBV13	TRBJ2-2
TGTGCCAGCAGGCCGGACAGGGTAGGATACTCTGGAAACACCATATATTTT	CASRPDRVGYSGNTIYF	TRBV6-2	TRBJ1-3
TGCGCCAGCAGCCAAGCCACCAGGGCTCGTGGCTACACCTTC	CASSQATRARGYTF	TRBV4-1	TRBJ1-2
TGCGCCAGCAGCCCGGCCAAGCGGGAGGAAAAACTGTTTTTT	CASSPAKREEKLFF	TRBV5-1	TRBJ1-4
TGTGCCAGCAGCGGATGTGACGCAGACACAGATACGCAGTATTTT	CASSGCDADTDTQYF	TRBV7-9	TRBJ2-3
TGCGCCAGCAGTGAGACCGTGGACAGGGTTAACACCGGGGAGCTGTTTTTT	CASSETVDRVNTGELFF	TRBV10-1	TRBJ2-2
TGTGCCAGCAGCAACTCTTCGGGGACACAACCCACCGGGGAGCTGTTTTTT	CASSNSSGTQPTGELFF	TRBV6-6	TRBJ2-2
TGTGCCAGCAGCTTTCAGCGGGAGGAGAACACTGAAGCTTTCTTT	CASSFQREENTEAFF	TRBV11-3	TRBJ1-1
TGTGCCAGTAACTCTCGCGACAGGGATGGTTCCACCACTGAAGCTTTCTTT	CASNSRDRDGSTTEAFF	TRBV19	TRBJ1-1
TGCGCCAGCAGCCAAGATTTCAGGGCAAGATGCAATCAGCCCCAGCATTTT	CASSQDFRARCNQPQHF	TRBV4-3	TRBJ1-5
TGCGCCAGCAGCGCGAGTGGGGGTTCTGAAAAGAACACTGAAGCTTTCTTT	CASSASGGSEKNTEAFF	TRBV5-1	TRBJ1-1
TGCGCCAGCAAAGGCAGGGTAGCGACCCAGTACTTC	CASKGRVATQYF	TRBV5-1	TRBJ2-5
TGTGCCAGCAGCCAGTCCGCGGGGAGCCCTACTTCCTACGAGCAGTACTTC	CASSQSAGSPTSYEQYF	TRBV4-2	TRBJ2-7
TGCGCCACAGCGGCCGACACAGATACGCAGTATTTT	CATAADTDTQYF	TRBV10-1	TRBJ2-3
TGTGCCAGCAGCTTAGATCCCCTAGCGGGGTTAAACAATGAGCAGTTCTTC	CASSLDPLAGLNNEQFF	TRBV11-2	TRBJ2-1
TGTGCCAGCAGCCAGGGCAATCAGCCCCAGCATTTT	CASSQGNQPQHF	TRBV5-5	TRBJ1-5
TGTGCCAGCAGTACTGGGGGCGTTATTCACGAGCAGTACTTC	CASSTGGVIHEQYF	TRBV12-3	TRBJ2-7
TGTGCTAGTGGTTTCCGCTTGGGGGCGGACGAGCAGTACTTC	CASGFRLGADEQYF	TRBV12-5	TRBJ2-7
TGTGCCAGCAGCTTGTATACGCTTATGGGGGGAGAGCCCAATCAGCCCCAGCATTTT	CASSLYTLMGGEPNQPQHF	TRBV7-2	TRBJ1-5
TGTGCCAGCAGTTACATGTCCGGGTGGGGAGGCTCCTACGAGCAGTACTTC	CASSYMSGWGGSYEQYF	TRBV6-3	TRBJ2-7
TGTGCCAGCAGCCCCCGGGACGGCACGTCAGAAAAACTGTTTTTT	CASSPRDGTSEKLFF	TRBV11-2	TRBJ1-4
TGTGCCTGGAGTGTACGTAAGGGGGAGAAGAATGGGGGACACGGCTACACCTTC	CAWSVRKGEKNGGHGYTF	TRBV30	TRBJ1-2
TGTGCCAGCAGCTTAGTGGGATTAAGCGGGAGGGATACGGTGGTGGGCTACACCTTC	CASSLVGLSGRDTVVGYTF	TRBV7-2	TRBJ1-2
TGTGCCCCGGGACTATCTATGAACACTGAAGCTTTCTTT	CAPGLSMNTEAFF	TRBV6-4	TRBJ1-1
TGTGCCAGCATGGGACTTTTTCCTCACCCATACAATGAGCAGTTCTTC	CASMGLFPHPYNEQFF	TRBV6-3	TRBJ2-1
TGTGCCAGCAGTTATGATCGGGGACGATGCAAAAACATTCAGTACTTC	CASSYDRGRCKNIQYF	TRBV6-2	TRBJ2-4
TGCAGTGCTAGAGATCCCCTCTCCCAGCGGGGTGTCAGCTCCTACAATGAGCAGTTCTTC	CSARDPLSQRGVSSYNEQFF	TRBV20-1	TRBJ2-1
TGTGCCAAAGGACAGGGGCGGGGGGGTTCGGAGGGAAACACCATATATTTT	CAKGQGRGGSEGNTIYF	TRBV28	TRBJ1-3
TGCGCCAGCAGGGGCGGGACAGGGAAAACTTATGAAAAACTGTTTTTT	CASRGGTGKTYEKLFF	TRBV5-1	TRBJ1-4
TGTGCCAGCAGGGTAAATAGAAGACGGGTGATGGGAGCCTACGAGCAGTACTTC	CASRVNRRRVMGAYEQYF	TRBV28	TRBJ2-7
TGCAGTGCTTGGGATAGGGAGCTAGCCAAAAACATTCAGTACTTC	CSAWDRELAKNIQYF	TRBV20-1	TRBJ2-4
TGTGCCACCGTTCGTACATCGGGGCTGCCCTATGGCTACACCTTC	CATVRTSGLPYGYTF	TRBV24-1	TRBJ1-2
TGCAGTGCTAGACGGGCCTTACACACTGAAGCTTTCTTT	CSARRALHTEAFF	TRBV20-1	TRBJ1-1
TGTGCCAGCAGCTCTAGGGGCGCCGTGGCTTACTCACTTTACGAGCAGTACTTC	CASSSRGAVAYSLYEQYF	TRBV13	TRBJ2-7
TGTGCCAGCAGCTTCCCGGGCCCGTCCGGACCCGGGGAGCTGTTTTTT	CASSFPGPSGPGELFF	TRBV11-3	TRBJ2-2
TGTGCCAGCACCTGGAAACCGGGCCAAGCCAAAAACATTCAGTACTTC	CASTWKPGQAKNIQYF	TRBV27	TRBJ2-4
TGTGCCAGCAGCTTAGTGCGGGGCCGGGCTACCACCTACGAGCAGTACTTC	CASSLVRGRATTYEQYF	TRBV7-9	TRBJ2-7
TGTGCCAGCAGCTTGCCTTGGGGGCCTGGAAACACCATATATTTT	CASSLPWGPGNTIYF	TRBV5-8	TRBJ1-3
TGTGCCAGCAGTTTATTACTAGACACTGAAGCTTTCTTT	CASSLLLDTEAFF	TRBV28	TRBJ1-1
TGTGCCTGGAGTCTCCCCCGACCTAGCGGGGAACCAGATACGCAGTATTTT	CAWSLPRPSGEPDTQYF	TRBV30	TRBJ2-3
TGTGCCACCCGCGGGGGCGATCAGCCCCAGCATTTT	CATRGGDQPQHF	TRBV6-1	TRBJ1-5
TGTGCCAGCAGTTACGTGGGGGTTCAGCCCCAGCATTTT	CASSYVGVQPQHF	TRBV6-5	TRBJ1-5
TGTGCCACCAGTGATGGGGGCCCGACTAGCTACCGTGTTCCAGATACGCAGTATTTT	CATSDGGPTSYRVPDTQYF	TRBV24-1	TRBJ2-3
TGTGCCTGGTTCCGCGGGTCTCGGGGAAACACCATATATTTT	CAWFRGSRGNTIYF	TRBV30	TRBJ1-3
TGTGCCAGCAGCCATGCGGACAGGGTTGCGGAAGCTTTCTTT	CASSHADRVAEAFF	TRBV4-2	TRBJ1-1
TGTGCCAGCATCCCCCGGGACAGGGCCCAGATAAGCTATGGCTACACCTTC	CASIPRDRAQISYGYTF	TRBV2	TRBJ1-2
TGTGCCAGCAGCTTGTCGACTAGCGGGAGCAGCAATCAGCCCCAGCATTTT	CASSLSTSGSSNQPQHF	TRBV5-6	TRBJ1-5
TGTGCCAGCAGGGGGAATGGGGGGTCACCCTACGAGCAGTACTTC	CASRGNGGSPYEQYF	TRBV27	TRBJ2-7
TGCAGTGCTAGCTGCAAAGGGGAAAGCGAGCAGTACTTC	CSASCKGESEQYF	TRBV20-1	TRBJ2-7
TGTGCCACTCCACTTGGGAAGTGCCGGTTAGGGATTAGCACAGATACGCAGTATTTT	CATPLGKCRLGISTDTQYF	TRBV19	TRBJ2-3
TGTGCCAGTAGCTCTCAGGGGGAAAAACTGTTTTTT	CASSSQGEKLFF	TRBV27	TRBJ1-4
TGTGCCAGCGTATGCAAGGGGAAAGCTAACTATGGCTACACCTTC	CASVCKGKANYGYTF	TRBV5-4	TRBJ1-2
TGTGCCAGCCCAGGGGGATGTAGGACCTCCTATAATTCACCCCTCCACTTT	CASPGGCRTSYNSPLHF	TRBV27	TRBJ1-6
TGTGCCAGCAAAGGGGGGGGGATCAGCTCCTACGAGCAGTACTTC	CASKGGGISSYEQYF	TRBV6-2	TRBJ2-7
TGTGCCACCAGTGTAGGGGCCACAGATACGCAGTATTTT	CATSVGATDTQYF	TRBV24-1	TRBJ2-3
TGTGCCAGCAGTCAGGGTTCACCCCTCCACTTT	CASSQGSPLHF	TRBV27	TRBJ1-6
TGTGCCAGCCCCCCCTGTACGCGGGAGGGGGGAGATACGCAGTATTTT	CASPPCTREGGDTQYF	TRBV27	TRBJ2-3
TGTGCCAGCAGCTTTCTCACCCGGGGTGAGAATCCGAACACCGGGGAGCTGTTTTTT	CASSFLTRGENPNTGELFF	TRBV5-5	TRBJ2-2
TGTGCCAGCAGCGAAAGACAGGAAGCTACCTACGAGCAGTACTTC	CASSERQEATYEQYF	TRBV9	TRBJ2-7
TGTGCTAGTGGTGGGCAGGGGGGGTGGGGAAAACCCGTGGAAAATGGCTACACCTTC	CASGGQGGWGKPVENGYTF	TRBV12-5	TRBJ1-2
TGCGCCAGCAGCTGCGGGCTTCCGAGAAACACTGAAGCTTTCTTT	CASSCGLPRNTEAFF	TRBV5-1	TRBJ1-1
TGTGCCAGCAGCGGCGCCCCCTTCAGGGGGACCTACGAGCAGTACTTC	CASSGAPFRGTYEQYF	TRBV3-1	TRBJ2-7
TGTGCCAGCAGCGGCTGGGGGGGCAACCAAGAGACCCAGTACTTC	CASSGWGGNQETQYF	TRBV7-9	TRBJ2-5
TGTGCCAGCAGTGGGCTAGGTCCGGGGGGCGATGAGCAGTTCTTC	CASSGLGPGGDEQFF	TRBV2	TRBJ2-1
TGTGCCAGCAGAGGGGGATTAAATTCACCCCTCCACTTT	CASRGGLNSPLHF	TRBV27	TRBJ1-6
TGTGCCAGCAGCCAAGTCCGACTACAGGGAGAAAAACTGTTTTTT	CASSQVRLQGEKLFF	TRBV14	TRBJ1-4
TGTGCCAGCTCCCCCAGGGGAAGGAACACTGAAGCTTTCTTT	CASSPRGRNTEAFF	TRBV18	TRBJ1-1
TGTGCCAGCAGCTGTGCTCCCTGCAACATTCAGTACTTC	CASSCAPCNIQYF	TRBV11-2	TRBJ2-4
TGTGCCAGCAGTGAAGCCCGGACAGGCACTGAAGCTTTCTTT	CASSEARTGTEAFF	TRBV6-1	TRBJ1-1
TGTGCCATCAGCGGTCCCCCGGCCCGGACGAACACTGAAGCTTTCTTT	CAISGPPARTNTEAFF	TRBV10-3	TRBJ1-1
TGTGCCAGCAGACTAGAGGTTCTGAACACTGAAGCTTTCTTT	CASRLEVLNTEAFF	TRBV7-6	TRBJ1-1
TGCGCCAGCAGCAAGTGCGGAGCTTCCCCCGGGACAGGGGGTCAAGAGACCCAGTACTTC	CASSKCGASPGTGGQETQYF	TRBV5-1	TRBJ2-5
TGTGCCACCAAGAGGAAAAGGGGGGGCAGGGTCTTC	CATKRKRGGRVF	TRBV24-1	TRBJ2-1
TGCGCCAGCAGCCGACAGGGGGCAGGAATAGGGGTGAACACTGAAGCTTTCTTT	CASSRQGAGIGVNTEAFF	TRBV5-1	TRBJ1-1
TGTGCCAGCAGCTGGGCGGCGGGCTCTGGAAACACCATATATTTT	CASSWAAGSGNTIYF	TRBV7-6	TRBJ1-3
TGTGCCAGCAGCTTAACTTTGGGGAGCCACAATCAGCCCCAGCATTTT	CASSLTLGSHNQPQHF	TRBV7-4	TRBJ1-5
TGTGCCAGCAGCCCCTCAGGGAGCACAGATACGCAGTATTTT	CASSPSGSTDTQYF	TRBV5-8	TRBJ2-3
TGTGCCAGCAGCTTACAGGGGGCGCAGTATTTT	CASSLQGAQYF	TRBV7-2	TRBJ2-3
TGTGCCAAACATCACACTGAAGCTTTCTTT	CAKHHTEAFF	TRBV10-3	TRBJ1-1
TGTGCCAGCACCCGGGGACAGGGGAGCGCTGGGGCCAACGTCCTGACTTTC	CASTRGQGSAGANVLTF	TRBV6-4	TRBJ2-6
TGTGCCAGCAATCCTCCGAGGTCTCAGGTCTTC	CASNPPRSQVF	TRBV6-4	TRBJ2-1
TGTGCCAGTAGTATAGAGTCAGCTAACCACGGGGGAACCGACTATGGCTACACCTTC	CASSIESANHGGTDYGYTF	TRBV19	TRBJ1-2
TGTGCCTGGAGTGTACAATGGGTCTTC	CAWSVQWVF	TRBV30	TRBJ2-1
TGTGCCAGCAGGAGCCTTCAGACATTGAACACTGAAGCTTTCTTT	CASRSLQTLNTEAFF	TRBV28	TRBJ1-1
TGTGCTAGTGGTTGGATGCGGGAGCGTCCCACCGGGGAGCTGTTTTTT	CASGWMRERPTGELFF	TRBV12-5	TRBJ2-2
TGTGCCAGCAGCCTCTCCGTGGACATTACGCAGTATTTT	CASSLSVDITQYF	TRBV12-4	TRBJ2-3
TGCGCCAGCAGTGAGTCGTCCTCATGCAGGACCGAAAAACTGTTTTTT	CASSESSSCRTEKLFF	TRBV10-2	TRBJ1-4
TGCAGTGCTAGAGATGCTAGCCGGGACTTCCCATTAGAGACCCAGTACTTC	CSARDASRDFPLETQYF	TRBV20-1	TRBJ2-5
TGTGCCAGCAGCTTAGATTGGTTCGCCCTTCGGACAGCGAATCAGCCCCAGCATTTT	CASSLDWFALRTANQPQHF	TRBV11-3	TRBJ1-5
TGTGCCAGCAGCTTTCGACAGGGAAACTTAAAACTGTTTTTT	CASSFRQGNLKLFF	TRBV11-3	TRBJ1-4
TGTGCCACACGGGGGGCCTCAGTGCGGGGTAAAGAGACCCAGTACTTC	CATRGASVRGKETQYF	TRBV24-1	TRBJ2-5
TGCGCCAGCAGTCTTTCCGGGACCCAGATAGATACGCAGTATTTT	CASSLSGTQIDTQYF	TRBV10-1	TRBJ2-3
TGTGCCAGCTGCCGGGACATAGTTGGCTACACCTTC	CASCRDIVGYTF	TRBV7-9	TRBJ1-2
TGCGCCAGCAGCTCCCCAGGGGGAACTGAAGCTTTCTTT	CASSSPGGTEAFF	TRBV5-1	TRBJ1-1
TGTGCCAGCACCGGAAGGTGGGGCGGAGAAAATGAGCAGTTCTTC	CASTGRWGGENEQFF	TRBV12-3	TRBJ2-1
TGTGCCAGTAGTATAAGAAGCTCCTACAATGAGCAGTTCTTC	CASSIRSSYNEQFF	TRBV19	TRBJ2-1
TGCGCCAGCAGCTTGAATCAGGGCCCCAGGGGAAAGAATCAGCCCCAGCATTTT	CASSLNQGPRGKNQPQHF	TRBV5-1	TRBJ1-5
TGTGCCAGCATGGGAGGGACGGGACTTGGTCCTCAAGAGACCCAGTACTTC	CASMGGTGLGPQETQYF	TRBV7-9	TRBJ2-5
TGTGCCAGCAGTGAAACTCTAGCGGGCTTGGGGTCTACGCAGTTCTTC	CASSETLAGLGSTQFF	TRBV6-1	TRBJ2-1
TGTGCCAGCAGCGTCGCCGGAGGGCGGGGGGAGCTGTTTTTT	CASSVAGGRGELFF	TRBV5-4	TRBJ2-2
TGTGCCTGGAGGGGAAACGCCAAAAACATTCAGTACTTC	CAWRGNAKNIQYF	TRBV30	TRBJ2-4
TGTGCCAGCAGTTCGAGGCCAGCGAACACCGGGGAGCTGTTTTTT	CASSSRPANTGELFF	TRBV6-5	TRBJ2-2
TGTGCCAGCAGCTTAGGGACTAGGGGGAAAAGCTCCTACGAGCAGTACTTC	CASSLGTRGKSSYEQYF	TRBV7-9	TRBJ2-7
TGCGCCAGCAGCGGGCGGCTGAACACTGAAGCTTTCTTT	CASSGRLNTEAFF	TRBV5-1	TRBJ1-1
TGCGCCAGCAGTGATGCCTTGGAGGGTGAGACCCAGTACTTC	CASSDALEGETQYF	TRBV10-1	TRBJ2-5
TGTGCCAGCAGTTTCGGGAAGGGGGGGCGCGAAAACACAGATACGCAGTATTTT	CASSFGKGGRENTDTQYF	TRBV27	TRBJ2-3
TGTGCCAGCCTCACTGGGTCGGGGGGATCGAGCTCCTACGAGCAGTACTTC	CASLTGSGGSSSYEQYF	TRBV27	TRBJ2-7
TGTGCCAGTAAAGGGGGGGACACTGAAGCTTTCTTT	CASKGGDTEAFF	TRBV19	TRBJ1-1
TGCAGTGCCTCATTCGGACTAGCGGTAGCAGATACGCAGTATTTT	CSASFGLAVADTQYF	TRBV20-1	TRBJ2-3
TGTGCCATCAGTGTTGACAGGGGATTCCCCGAAGCTTTCTTT	CAISVDRGFPEAFF	TRBV10-3	TRBJ1-1
TGTGCCAGCAGCTTAGTGATTGGTATTGCGGGAGGGCCCAAAAACATTCAGTACTTC	CASSLVIGIAGGPKNIQYF	TRBV7-2	TRBJ2-4
TGTGCCAGCAAGGGGGTTGCGCCCCAGCATTTT	CASKGVAPQHF	TRBV7-4	TRBJ1-5
TGTGCCAGCAGCAAACAAGGTCTTTCCAGGGGCCCAGACCCCAATCAGCCCCAGCATTTT	CASSKQGLSRGPDPNQPQHF	TRBV13	TRBJ1-5
TGTGCCACCAGTGATACCAGGGTGGAGATCTACGAGCAGTACTTC	CATSDTRVEIYEQYF	TRBV24-1	TRBJ2-7
TGTGCCAGCAGCTGGCCGGGACCAGACACCGGGGAGCTGTTTTTT	CASSWPGPDTGELFF	TRBV11-3	TRBJ2-2
TGCGCCAGCAGGTTCCGGGACAGGGGACGGAATGAGCAGTTCTTC	CASRFRDRGRNEQFF	TRBV5-1	TRBJ2-1
TGCGCCAGCAGCCAGACAGGGACGGTATATAGCAATCAGCCCCAGCATTTT	CASSQTGTVYSNQPQHF	TRBV5-1	TRBJ1-5
TGTGCCAGCCACTATCTGGAGACACGCTCACATGAGCAGTTCTTC	CASHYLETRSHEQFF	TRBV7-9	TRBJ2-1
TGTGCCAGCAGCGCTTCCAGGGGTGGGAACACTGAAGCTTTCTTT	CASSASRGGNTEAFF	TRBV9	TRBJ1-1
TGTGCCAGCAGTAAACTGGAGGGACTAGCGGGTCCCGGGGAGCTGTTTTTT	CASSKLEGLAGPGELFF	TRBV27	TRBJ2-2
TGTGCCAGCAGCCGGACGGATAGCAATCAGCCCCAGCATTTT	CASSRTDSNQPQHF	TRBV9	TRBJ1-5
TGTGCCACCAGTAAGGGGATTCAACGGACCGTTGAAAAACTGTTTTTT	CATSKGIQRTVEKLFF	TRBV24-1	TRBJ1-4
TGTGCCAGCAGTGAAGGATACCTTGGTTACGAGGCGAGCTCCTATAATTCACCCCTCCACTTT	CASSEGYLGYEASSYNSPLHF	TRBV25-1	TRBJ1-6
TGCAGTGCTAGGAGTCGGGACAGGGTCACTGAAGCTTTCTTT	CSARSRDRVTEAFF	TRBV20-1	TRBJ1-1
TGTGCCAGCAGCAGGCCAGGGTATGAGATTGGAAACACCATATATTTT	CASSRPGYEIGNTIYF	TRBV7-2	TRBJ1-3
TGTGCCAGCAGTTCCATTGACAGGGTTTGGCTTGGGGCCAACGTCCTGACTTTC	CASSSIDRVWLGANVLTF	TRBV27	TRBJ2-6
TGCGCCAGCAGCACCACGCTAAGGGATTACAATGAGCAGTTCTTC	CASSTTLRDYNEQFF	TRBV5-1	TRBJ2-1
TGTGCCACCGGCCCTGGTCCGCAGCATTTT	CATGPGPQHF	TRBV24-1	TRBJ1-5
TGTGCCAGCAGCCCATATGACAGAGCCGCCTCTGGAAACACCATATATTTT	CASSPYDRAASGNTIYF	TRBV9	TRBJ1-3
TGTGCCAGCATCCCCGGGACAGATGAGCAGTTCTTC	CASIPGTDEQFF	TRBV6-4	TRBJ2-1
TGTGCTAGTGGTTTGGTATACCGGGGGCCACCTTTCGGACAGGGACCCCCCAATCAGCCCCAGCATTTT	CASGLVYRGPPFGQGPPNQPQHF	TRBV12-5	TRBJ1-5
TGTGCCAGCAGCCCCGAGGCATCCAGTGCGGGGGCCAACGTCCTGACTTTC	CASSPEASSAGANVLTF	TRBV13	TRBJ2-6
TGTGCCAGCCCACAGCCCCAGCATTTT	CASPQPQHF	TRBV9	TRBJ1-5
TGTGCCAGCAGCGGGACAGGGAACTATGGCTACACCTTC	CASSGTGNYGYTF	TRBV13	TRBJ1-2
TGTGCCTGGAGCTGGACAGTTTGTGGCTACACCTTC	CAWSWTVCGYTF	TRBV30	TRBJ1-2
TGTGCCAGTAGTAGGTTCCGGGACACTGAAGCTTTCTTT	CASSRFRDTEAFF	TRBV19	TRBJ1-1
TGTGCCAGCAGTTGGAAACAGGGAGCTTTCTACGAGCAGTACTTC	CASSWKQGAFYEQYF	TRBV12-4	TRBJ2-7
TGTGCCAGCAGCATAAACGAAGAGGGGGGGGATACGCAGTATTTT	CASSINEEGGDTQYF	TRBV13	TRBJ2-3
TGTGCCAGCAGTTTTATATGCCCCTACGAGCAGTACTTC	CASSFICPYEQYF	TRBV28	TRBJ2-7
TGTGCCAGCACGATGATGATACTAGCGGGGTCTGAAGAGACCCAGTACTTC	CASTMMILAGSEETQYF	TRBV6-3	TRBJ2-5
TGTGCCAGCAGTCGGGGCTCCAGGGGGAACACCGGGGAGCTGTTTTTT	CASSRGSRGNTGELFF	TRBV3-1	TRBJ2-2
TGTGCCAGCAGTTTCTCTAAGAGGCAGAAGCTGCACTCCGAGCAGTACTTC	CASSFSKRQKLHSEQYF	TRBV12-4	TRBJ2-7
TGTGCCAGCTTCCAGTGGACCATTGTCAAGGGCAATCAGCCCCAGCATTTT	CASFQWTIVKGNQPQHF	TRBV2	TRBJ1-5
TGTGCCAGCAGCTTAGCGCTAGGACAGGAGATGCAAGAGACCCAGTACTTC	CASSLALGQEMQETQYF	TRBV7-6	TRBJ2-5
TGCGCCAGCAGCTCCGGGGACCGGGGTGGCTACACCTTC	CASSSGDRGGYTF	TRBV5-1	TRBJ1-2
TGCGCCAGCAGCCAAGGGGGCAGATACGAGCAGTACTTC	CASSQGGRYEQYF	TRBV4-3	TRBJ2-7
TGTGCCACCAGTGATAAGGGGGGAAGCTATGGCTACACCTTC	CATSDKGGSYGYTF	TRBV24-1	TRBJ1-2
TGTGCCAGCAGCTTACCTGGGGGACGCTACGAGCAGTACTTC	CASSLPGGRYEQYF	TRBV7-8	TRBJ2-7
TGTGCCAGCAGCCAAGCAGGAACCGTAGATGGCCTGCGGGAGGCGAATCAGCCCCAGCATTTT	CASSQAGTVDGLREANQPQHF	TRBV3-1	TRBJ1-5
TGTGCCACCAGTGATTCCCACCCCAGGGATGAGCAGTTCTTC	CATSDSHPRDEQFF	TRBV24-1	TRBJ2-1
TGTGCCAGCAGCGTCCAGCGGGAGGGCTACGAGCAGTACTTC	CASSVQREGYEQYF	TRBV7-9	TRBJ2-7
TGTGCCAGCAGCCCCCCTAGCGGGTGTAGCTCCTACAATGAGCAGTTCTTC	CASSPPSGCSSYNEQFF	TRBV11-2	TRBJ2-1
TGTGCCAGCGTACTCTACGAGCAGTACTTC	CASVLYEQYF	TRBV6-5	TRBJ2-7
TGTGCCAGCAGCTTGGGAGCGACAGGGAGGGGCTACACCTTC	CASSLGATGRGYTF	TRBV5-8	TRBJ1-2
TGTGCCAGCAGCTTCCCAAGGGGCATAAGCTCCTACAATGAGCAGTTCTTC	CASSFPRGISSYNEQFF	TRBV11-3	TRBJ2-1
TGTGCCACCGTGCGACACCGAGAAAAACTGTTTTTT	CATVRHREKLFF	TRBV24-1	TRBJ1-4
TGTGCCAGCAGCGGCTGGAGCTCCTATAATTCACCCCTCCACTTT	CASSGWSSYNSPLHF	TRBV5-6	TRBJ1-6
TGTGCCAGCAGTGCAGGGGCGCCCCAGCATTTT	CASSAGAPQHF	TRBV27	TRBJ1-5
TGTGCCAGCATGGACAGATTCGGCCCCTATGGCTACACCTTC	CASMDRFGPYGYTF	TRBV2	TRBJ1-2
TGCGCCAGCAGCCCCGGCCTGACCACTGAAGCTTTCTTT	CASSPGLTTEAFF	TRBV5-1	TRBJ1-1
TGTGCCAGCAGCTTAAGTTCCGACAGGACCAACTTATATTTT	CASSLSSDRTNLYF	TRBV7-4	TRBJ1-3
TGTGCCAGCAGCAGGAAGGGGAACGGCAATGAGCAGTTCTTC	CASSRKGNGNEQFF	TRBV11-3	TRBJ2-1
TGTGCCAGCAGAGACAGGGCCCGTGTTTACGAGCAGTACTTC	CASRDRARVYEQYF	TRBV6-3	TRBJ2-7
TGTGCCAGCAGAGAGCTCTGGGGCTACGAGCAGTACTTC	CASRELWGYEQYF	TRBV14	TRBJ2-7
TGTGCCAGCAGTGACCAGGTACGGGCCTACGAGCAGTACTTC	CASSDQVRAYEQYF	TRBV6-1	TRBJ2-7
TGTGCCAGCAGTGAATGGGGGGCCGAGGGCTCCTACGAGCAGTACTTC	CASSEWGAEGSYEQYF	TRBV6-1	TRBJ2-7
TGTGCCAGCAGTTACCTCGGGGGGACAAGGGCCTACGAGCAGTACTTC	CASSYLGGTRAYEQYF	TRBV6-3	TRBJ2-7
TGTGCCAGCAGCTTAGTAAATGGGGGGGCTTTAGCCAAAAACATTCAGTACTTC	CASSLVNGGALAKNIQYF	TRBV11-2	TRBJ2-4
TGTGCCAGCAGCTTGCACGGGACAGGGGGGAAGAGGTTCCCTGTTCACTATGGCTACACCTTC	CASSLHGTGGKRFPVHYGYTF	TRBV5-6	TRBJ1-2
TGTGCCAGCAGTTACAGGAGCGGGAGTCGGACTGAAGCTTTCTTT	CASSYRSGSRTEAFF	TRBV6-5	TRBJ1-1
TGTGCCACCAGCAAAGGTTCAACCGGGACTAGCTCATCCTACGAGCAGTACTTC	CATSKGSTGTSSSYEQYF	TRBV24-1	TRBJ2-7
TGTGCCAGCAGCACAAGGGGACAGAGAGGCTATGGCTACACCTTC	CASSTRGQRGYGYTF	TRBV11-1	TRBJ1-2
TGTGCCAGCAGTTTAGAGGGGCATCTTGAAGCTTTCTTT	CASSLEGHLEAFF	TRBV12-4	TRBJ1-1
TGTGCCAGCAGCCCCTACCGGGACAGGGAAAGGAGCAGGAGGGAACCAGAAGGAAACACCATATATTTT	CASSPYRDRERSRREPEGNTIYF	TRBV7-3	TRBJ1-3
TGTGCCAGCAGCTTACAGGGGGCCCCTAAGGATGGCTACACCTTC	CASSLQGAPKDGYTF	TRBV13	TRBJ1-2
TGTGCCAGCAGCTTAAGGGGGGGCCTCCATGAGCAGTTCTTC	CASSLRGGLHEQFF	TRBV11-3	TRBJ2-1
TGTGCCAGCAGTGAATCCCCAATGAACACTGAAGCTTTCTTT	CASSESPMNTEAFF	TRBV6-1	TRBJ1-1
TGTGCCTCCACGGCGGGAGAAAACACCATATATTTT	CASTAGENTIYF	TRBV19	TRBJ1-3
TGTGCTAGCAGCACCCGGGAGGGGTCGGGTCAGCAGCCCCAGCATTTT	CASSTREGSGQQPQHF	TRBV7-7	TRBJ1-5
TGCGCCAGCATTTCGGGACGCGTGGTAGAGAATCAGCCCCAGCATTTT	CASISGRVVENQPQHF	TRBV4-1	TRBJ1-5
TGTGCCAGCAGCTTCGGGAGAGCTAGCGGGGCTAATGAGCAGTTCTTC	CASSFGRASGANEQFF	TRBV7-2	TRBJ2-1
TGCGCCAGCAGCCCCCGGGGGAGAGAGCAGTTCTTC	CASSPRGREQFF	TRBV4-1	TRBJ2-1
TGTGCCAGCAGCGTCCAAGCGGGACAGGGAAGTCCGTTAATCGGCCGGAAGGCTGAAGCTTTCTTT	CASSVQAGQGSPLIGRKAEAFF	TRBV9	TRBJ1-1
TGTGCCAGCAGCGTGGGCTCCCGAGGGACTAGCGGGGGGGGCAAAAACATTCAGTACTTC	CASSVGSRGTSGGGKNIQYF	TRBV13	TRBJ2-4
TGCGCCAGCAGCCAAGATCGCGGGAAAGGCTACACCTTC	CASSQDRGKGYTF	TRBV4-1	TRBJ1-2
TGTGCCAGCAAACGTTGGCATATCCCGAACAATGAGCAGTTCTTC	CASKRWHIPNNEQFF	TRBV6-5	TRBJ2-1
TGTGCCAGCAAGAGAAACCCGTTAGCCCCGTCCTACGAGCAGTACTTC	CASKRNPLAPSYEQYF	TRBV28	TRBJ2-7
TGTGCCAGCGGAATGACAGGACAGGGCAGGACGGGGAGTACAAATGAGCAGTTCTTC	CASGMTGQGRTGSTNEQFF	TRBV7-2	TRBJ2-1
TGTGCCAGCAGTTACCGCGTGGGACAGCTCTCTGGGGCCAACGTCCTGACTTTC	CASSYRVGQLSGANVLTF	TRBV6-5	TRBJ2-6
TGTGCCAGCAGCGTAGGTGTGTTCTGGGCTGAGCAGTACTTC	CASSVGVFWAEQYF	TRBV9	TRBJ2-7
TGTGCCAGCAGCGGACCAGGAAGTGCATACGAGCAGTACTTC	CASSGPGSAYEQYF	TRBV7-3	TRBJ2-7
TGTGCCAGCAGCCAAGAATGGGGCGGGGAGCTGTTTTTT	CASSQEWGGELFF	TRBV3-1	TRBJ2-2
TGTGCCAGCAGCGTAGGGAGGGACAGACCGAGGACAACCCTCTACGAGCAGTACTTC	CASSVGRDRPRTTLYEQYF	TRBV9	TRBJ2-7
TGTGCCAGCAGTTGTATCCGGGACATGATACAGAACACTGAAGCTTTCTTT	CASSCIRDMIQNTEAFF	TRBV12-3	TRBJ1-1
TGTGCCAGCGCTAGGGACGGGCATCAGCCCCAGCATTTT	CASARDGHQPQHF	TRBV6-5	TRBJ1-5
TGTGCCAGCAGTGGACTAGCGGCTGAGCAGTTCTTC	CASSGLAAEQFF	TRBV6-5	TRBJ2-1
TGTGCCAGCAGTAGTTTATCGGGAGGGACCGAGAATTCACCCCTCCACTTT	CASSSLSGGTENSPLHF	TRBV6-1	TRBJ1-6
TGCGCCAGCAGTCCCCCCGGGACAGGCTACGAGCAGTACTTC	CASSPPGTGYEQYF	TRBV4-1	TRBJ2-7
TGCGCCAGCAGCTTCCTAGGGGCCCGTCTGCGGGAAAGGACCTCCTACGAGCAGTACTTC	CASSFLGARLRERTSYEQYF	TRBV5-1	TRBJ2-7
TGTGCCAGCAGCGTTTACGGGACTAACAATGAGCAGTTCTTC	CASSVYGTNNEQFF	TRBV9	TRBJ2-1
TGTGCCAGCATTGGGTTGTATCCCGGGACAGGGAATTCCTCCTACGAGCAGTACTTC	CASIGLYPGTGNSSYEQYF	TRBV9	TRBJ2-7
TGTGCCAGCAGCTTAACCGCGGGCCCACCGGGACAGGGCTACAATGAAAAACTGTTTTTT	CASSLTAGPPGQGYNEKLFF	TRBV7-4	TRBJ1-4
TGTGCTAGTGGTTTGCGAGCGACAGGACTCGAGCAGTACTTC	CASGLRATGLEQYF	TRBV12-5	TRBJ2-7
TGTGCCAGCAGGGACCACGAAAAACTGTTTTTT	CASRDHEKLFF	TRBV5-4	TRBJ1-4
TGTGCCAGTAGTATGAAGTTAAGAGGGGGGGAGGAGCAGTTCTTC	CASSMKLRGGEEQFF	TRBV19	TRBJ2-1
TGTGCCAGCAGCCGCTACCCTTTCGGGGGGCTAGAGTACTTC	CASSRYPFGGLEYF	TRBV14	TRBJ2-7
TGTGCCAGCAGCTTAAAGAACAGGGAGTATAGCAATCAGCCCCAGCATTTT	CASSLKNREYSNQPQHF	TRBV7-3	TRBJ1-5
TGTGCCAGCAGCCTTGTTGGGACTAGCGGGGGGCTCGACAATGAGCAGTTCTTC	CASSLVGTSGGLDNEQFF	TRBV7-9	TRBJ2-1
TGTGCCAGCAGCTTAGATAACAGGGGTCAGCCCCAGCATTTT	CASSLDNRGQPQHF	TRBV11-2	TRBJ1-5
TGTGCCAGCAGTAGGGATGACAGGGTGACTGGGGTTAATGAAAAACTGTTTTTT	CASSRDDRVTGVNEKLFF	TRBV6-8	TRBJ1-4
TGTGCCAGTAGTTTTGGCAGTTTCCGGGGTGCGGTTTGGCCAGATCAGCCCCAGCATTTT	CASSFGSFRGAVWPDQPQHF	TRBV19	TRBJ1-5
TGTGCCAGCAGCCCCGCAGGGGGCGGTGAATCCTACGAGCAGTACTTC	CASSPAGGGESYEQYF	TRBV9	TRBJ2-7
TGCGCCAGCAGCCACATAGCGGTGAAGAACACCGGGGAGCTGTTTTTT	CASSHIAVKNTGELFF	TRBV4-3	TRBJ2-2
TGCGCCAGCAGCTCGGCCTTTACTAGCGGGAGACCGACACGAGATACGCAGTATTTT	CASSSAFTSGRPTRDTQYF	TRBV5-1	TRBJ2-3
TGTGCCAGCCTGGCGGGAGACCCCCGGACAAGGGACGAGCAGTACTTC	CASLAGDPRTRDEQYF	TRBV7-9	TRBJ2-7
TGTGCCAGCAGCTTCATGGATCAGGGCGGCAATCAGCCCCAGCATTTT	CASSFMDQGGNQPQHF	TRBV5-4	TRBJ1-5
TGTGCCAGCAGCCACAGACTAGCGGGAGGGGGCACCGAGCAGTACTTC	CASSHRLAGGGTEQYF	TRBV14	TRBJ2-7
TGTGCCAGCAGCATTCTCGGGGAGGTCTCTGGAAACACCATATATTTT	CASSILGEVSGNTIYF	TRBV7-3	TRBJ1-3
TGTGCCAGCAGCGCACTTAAGGGGGGTGCAACTAATGAAAAACTGTTTTTT	CASSALKGGATNEKLFF	TRBV9	TRBJ1-4
TGTGCCACCCCCCGAAGGGGCCGACTAGCCAAAAACATTCAGTACTTC	CATPRRGRLAKNIQYF	TRBV15	TRBJ2-4
TGCAGTGCTAGAGTCCAATGTCGGGAGCGAGACGGAAGCCTACCGTCCTACGAGCAGTACTTC	CSARVQCRERDGSLPSYEQYF	TRBV20-1	TRBJ2-7
TGTGCCACCCCCCGGGACAGGGGCTTTACAGCCTACGAGCAGTACTTC	CATPRDRGFTAYEQYF	TRBV24-1	TRBJ2-7
TGTGCCAGCAGCCAGCCGGGACTAGCGGGTAGCGAATGTAGCTCCTACGAGCAGTACTTC	CASSQPGLAGSECSSYEQYF	TRBV7-3	TRBJ2-7
TGTGCCAGCAGCCAAGTCCCCGGGACAGCCGCCAATCAGCCCCAGCATTTT	CASSQVPGTAANQPQHF	TRBV4-2	TRBJ1-5
TGCGCCGTGCGGACAGGGAATCACAATGAGCAGTTCTTC	CAVRTGNHNEQFF	TRBV5-1	TRBJ2-1
TGTGCCAGCAGGGTGGGTCTTAAAATTTCTGGGACAGGGGAGCCCTACGAGCAGTACTTC	CASRVGLKISGTGEPYEQYF	TRBV6-4	TRBJ2-7
TGTGCCAGCAGCCCCCATGGGACAGGGGGTATAGAAGTCACAGATACGCAGTATTTT	CASSPHGTGGIEVTDTQYF	TRBV7-3	TRBJ2-3
TGTGCCAGCAGTTTACTACAGTACTGTTACGAGCAGTACTTC	CASSLLQYCYEQYF	TRBV12-4	TRBJ2-7
TGTGCCAGCAGCTCCAAGGGGGCTGGACGTTCAATTGGAAACACCATATATTTT	CASSSKGAGRSIGNTIYF	TRBV13	TRBJ1-3
TGCGCCAGCAGCGGGGAAAGGGATCAGCCCCAGCATTTT	CASSGERDQPQHF	TRBV5-1	TRBJ1-5
TGTGCCAGCAGTGATGTGCTGTGTTACAATGAGCAGTTCTTC	CASSDVLCYNEQFF	TRBV6-4	TRBJ2-1
TGTGCCAGCTGCGGAAAGGGCTACGAGCAGTACTTC	CASCGKGYEQYF	TRBV5-6	TRBJ2-7
TGCAGCCCAAGGGGACTATACGAGCAGTACTTC	CSPRGLYEQYF	TRBV29-1	TRBJ2-7
TGTGCCAGCAATAACCGATATCGAGCGGGAAACTACGAGCAGTACTTC	CASNNRYRAGNYEQYF	TRBV6-5	TRBJ2-7
TGTGCCAGTTACTTGTTGCCCGAGACAGGGGGCCCTGAAGCTTTCTTT	CASYLLPETGGPEAFF	TRBV2	TRBJ1-1
TGTGCCAGCAGTTCCGGGGGGGCCTACGAGCAGTACTTC	CASSSGGAYEQYF	TRBV9	TRBJ2-7
TGTGCCAGCAGCTCTCGACTTACGGGCACAGATACGCAGTATTTT	CASSSRLTGTDTQYF	TRBV13	TRBJ2-3
TGCAGCGTAAACAGAGTAGGAAGGGGCTATGGCTACACCTTC	CSVNRVGRGYGYTF	TRBV29-1	TRBJ1-2
TGCGCCAGCAGCCAGGACAGGGAGGAAAAACTGTTTTTT	CASSQDREEKLFF	TRBV4-1	TRBJ1-4
TGTGCCAGCAGCAGCGTTGGTTTTGGGGAGCTGTTTTTT	CASSSVGFGELFF	TRBV7-3	TRBJ2-2
TGCAGCGCGACCTACGAGCAGTACTTC	CSATYEQYF	TRBV29-1	TRBJ2-7
TGTGCCAGCAGCTTAGCCCTTATCAGGGTTGAGGGCACCGGGGAGCTGTTTTTT	CASSLALIRVEGTGELFF	TRBV11-2	TRBJ2-2
TGTGCCAGCAGCACCACGAACTTTAAGGGACTAGCGGGGGGGCCAGCAAATACGCAGTATTTT	CASSTTNFKGLAGGPANTQYF	TRBV11-1	TRBJ2-3
TGTGCCACCAGTGATTTGGCCCCCCTTCTACCGGATAATGAAAAACTGTTTTTT	CATSDLAPLLPDNEKLFF	TRBV24-1	TRBJ1-4
TGTGCCAGCAGCGGTGGGGGGCCATCGCACAATGAGCAGTTCTTC	CASSGGGPSHNEQFF	TRBV5-4	TRBJ2-1
TGTGCCAGCAGTGAAGGGGGGGCCTGGGGGGGCCGAGGTACGCAGTATTTT	CASSEGGAWGGRGTQYF	TRBV6-1	TRBJ2-3
TGTGCCAGCAGTGAAATGTCCAGGGAGGTTTCACCCCTCCACTTT	CASSEMSREVSPLHF	TRBV2	TRBJ1-6
TGTGCCTGGGGCAGGACTTACCATCAGCCCCAGCATTTT	CAWGRTYHQPQHF	TRBV30	TRBJ1-5
TGTGCCAGCAGCCCGGAGGGGTGTCCCTACAATGAGCAGTTCTTC	CASSPEGCPYNEQFF	TRBV5-4	TRBJ2-1
TGTGCCAGCCCCCGCCGAACCCCGAGGTACTCTTATTTT	CASPRRTPRYSYF	TRBV6-2	TRBJ1-3
TGTGCCAGCAGCCAAGTGATAGGAAGCTATGGCTACACCTTC	CASSQVIGSYGYTF	TRBV14	TRBJ1-2
TGCGCCAGCAGTGATGCTGGGACTAGGATCTCCTACGAGCAGTACTTC	CASSDAGTRISYEQYF	TRBV10-1	TRBJ2-7
TGCGCCAGCTTAAAGGGGCCTCCCCAGCATTTT	CASLKGPPQHF	TRBV5-1	TRBJ1-5
TGTGCCAGCAGCTTGGTAAGGGGGGAGGTGAACACTGAAGCTTTCTTT	CASSLVRGEVNTEAFF	TRBV7-9	TRBJ1-1
TGCGCCAGCCTCCCGGGACTGCACAATCAGCCCCAGCATTTT	CASLPGLHNQPQHF	TRBV4-3	TRBJ1-5
TGCGCCAGCAGCCAACACCTCCGGGATCAGCCCCAGCATTTT	CASSQHLRDQPQHF	TRBV4-3	TRBJ1-5
TGCGCCAGCAGTGTTAGAGAGACCCAGTACTTC	CASSVRETQYF	TRBV10-1	TRBJ2-5
TGTGCCAGCAGCGAAGCAGGACAGAAGCGTGATAGGGGCGAAGCTTTCTTT	CASSEAGQKRDRGEAFF	TRBV7-6	TRBJ1-1
TGCAGTGCGAATCCGGGGAACGTCTACGAGCAGTACTTC	CSANPGNVYEQYF	TRBV20-1	TRBJ2-7
TGTGCCACCAGTGATTTGGGGGGCCCCTGGACAGATACGCAGTATTTT	CATSDLGGPWTDTQYF	TRBV24-1	TRBJ2-3
TGCAGTGCAAATGGGACAGGATGGGTTAATGAAAAACTGTTTTTT	CSANGTGWVNEKLFF	TRBV20-1	TRBJ1-4
TGTGCCAGCAGCTTAGACCGTACAGGGCGGGTAGATACGCAGTATTTT	CASSLDRTGRVDTQYF	TRBV7-9	TRBJ2-3
TGCGCCAGCAGCCCTAGGGGGGGGTTTTACAATGAGCAGTTCTTC	CASSPRGGFYNEQFF	TRBV5-1	TRBJ2-1
TGTGCCAGCAGCTGGCGACTAGCGTCAGTGGATTACGAGCAGTACTTC	CASSWRLASVDYEQYF	TRBV11-1	TRBJ2-7
TGTGCCAGCAGCAGGGGGCCCGAAGGAGGGGCTGAAGCTTTCTTT	CASSRGPEGGAEAFF	TRBV7-9	TRBJ1-1
TGCGCCAGCAGCCAAGAACCTTGCCCTAGCGGGGTTTTCTTC	CASSQEPCPSGVFF	TRBV4-3	TRBJ2-1
TGTGCCAAGGGGGACAGGGGGAGGCCCTACGAGCAGTACTTC	CAKGDRGRPYEQYF	TRBV7-6	TRBJ2-7
TGTGCCAGCAGCCAAGATTACAAGGGCACAGGGAAGAATGAAAAACTGTTTTTT	CASSQDYKGTGKNEKLFF	TRBV4-2	TRBJ1-4
TGTGCCAGCAGCTTAAAGGCCGACAGGGTTTCCTATCCCGGGGAGCTGTTTTTT	CASSLKADRVSYPGELFF	TRBV7-9	TRBJ2-2
TGTGCCAGCAGCTTAGGGACCAGCAATCAGCCCCAGCATTTT	CASSLGTSNQPQHF	TRBV7-2	TRBJ1-5
TGCAGTGCTAGAGTACAGGGCAGAACTGATCAGCCCCAGCATTTT	CSARVQGRTDQPQHF	TRBV20-1	TRBJ1-5
TGTGCCAGCAGCTTAGCACCGGGACTAAACAGTACTTACAATGAGCAGTTCTTC	CASSLAPGLNSTYNEQFF	TRBV11-2	TRBJ2-1
TGCGCCAGCCTGACAGCGCTTAACAATGAGCAGTTCTTC	CASLTALNNEQFF	TRBV10-1	TRBJ2-1
TGTGCCAGCATTTTTCCCAGGGGAAACCGAGGGTGCGGGGAGCTGTTTTTT	CASIFPRGNRGCGELFF	TRBV2	TRBJ2-2
TGTGCCAGCAGCTTTAAGACAGCTAGCGGAGCTTTCTTT	CASSFKTASGAFF	TRBV5-6	TRBJ1-1
TGTGCCAGCAGTAAACCCGGGGGGCCGCCCTACGAGCAGTACTTC	CASSKPGGPPYEQYF	TRBV6-5	TRBJ2-7
TGTGCCAGCAGTGCTCGGTACACCGGGGAGCTGTTTTTT	CASSARYTGELFF	TRBV6-1	TRBJ2-2
TGTGCCAGCAGGGAACTAGAGTACAATGAGCAGTTCTTC	CASRELEYNEQFF	TRBV6-6	TRBJ2-1
TGCAGTGCTAGATCGGCAAACGATGAGCAGTTCTTC	CSARSANDEQFF	TRBV20-1	TRBJ2-1
TGTGCCAGCAGTTTAATGTGCGGACGCCACCAAGAGACCCAGTACTTC	CASSLMCGRHQETQYF	TRBV28	TRBJ2-5
TGTGCCACCAGTGATTTCCCGTCCATCTGCAACCGCTATGGCTACACCTTC	CATSDFPSICNRYGYTF	TRBV24-1	TRBJ1-2
TGCAGTGCATGGGGGGGAAGAGGGGAGCAGTTCTTC	CSAWGGRGEQFF	TRBV20-1	TRBJ2-1
TGTGCCAGCAGCTTAGTCCTAGGGGGCGATGAAAAACTGTTTTTT	CASSLVLGGDEKLFF	TRBV7-7	TRBJ1-4
TGTGCCAGCAGTTACCCCGGGGGACAGGGGGATAAGGGGCCTGAAGCTTTCTTT	CASSYPGGQGDKGPEAFF	TRBV6-5	TRBJ1-1
TGTGCCAGCAGTCAAGAACCCAAAAACATTCAGTACTTC	CASSQEPKNIQYF	TRBV6-1	TRBJ2-4
TGTGCCAGCAGCTCCCGGCTAGGCAATCAGCCCCAGCATTTT	CASSSRLGNQPQHF	TRBV9	TRBJ1-5
TGTGCCAGCTCACCACTCACTAGGGGGGGGTCCTACGAGCAGTACTTC	CASSPLTRGGSYEQYF	TRBV18	TRBJ2-7
TGTGCCAGCAGCCATGACAGTACAGATACGCAGTATTTT	CASSHDSTDTQYF	TRBV7-2	TRBJ2-3
TGTGCCAGCTCACCATCTGGGGGCCAAGGTGAAAAACTGTTTTTT	CASSPSGGQGEKLFF	TRBV18	TRBJ1-4
TGTGCCAGCTCACCATTCGGGGTGGGTGAGCAGTACTTC	CASSPFGVGEQYF	TRBV18	TRBJ2-7
TGCGCCAGCAGCCACTCGTTCGGGGGGCCCCACGAGCAGTACTTC	CASSHSFGGPHEQYF	TRBV4-1	TRBJ2-7
TGTGCCAGCAGCGACCACACCGGGGAGCTGTTTTTT	CASSDHTGELFF	TRBV9	TRBJ2-2
TGTGCCTTGTCCCGGGGGATGACCCAGTACTTC	CALSRGMTQYF	TRBV30	TRBJ2-5
TGCAGTGCTAGGGCGGGACTAGCGGGGGCCTACAATGAGCAGTTCTTC	CSARAGLAGAYNEQFF	TRBV20-1	TRBJ2-1
TGTGCCAGCAGCCAGTTGAGTGGCTCTGGAAACACCATATATTTT	CASSQLSGSGNTIYF	TRBV3-1	TRBJ1-3
TGTGCCAGCGACAGGGTGCATCTCAGGCAGTACTTC	CASDRVHLRQYF	TRBV7-3	TRBJ2-7
TGTGCCAGCAGTGACATGAACCTCGGGGGCAGGAGTTACAATGAGCAGTTCTTC	CASSDMNLGGRSYNEQFF	TRBV6-4	TRBJ2-1
TGTGCCAGCAGCCCCCAATCGACTTATCTCACCATATATTTT	CASSPQSTYLTIYF	TRBV13	TRBJ1-3
TGTGCCACCAGTGTTGGCACCGGAGGATCCTACGAGCAGTACTTC	CATSVGTGGSYEQYF	TRBV24-1	TRBJ2-7
TGTGCCAGTAGTATCCCCGGACACACTGAAGCTTTCTTT	CASSIPGHTEAFF	TRBV19	TRBJ1-1
TGTGCCAGCAGCGTTTCCTGGAGGGGGGGTGAGCAGTTCTTC	CASSVSWRGGEQFF	TRBV7-3	TRBJ2-1
TGTGCCAGCAGCTCGACCCTAACTAGCGGGAGGGCAGCCAATGAAGCTTTCTTT	CASSSTLTSGRAANEAFF	TRBV3-1	TRBJ1-1
TGTGCTAGTGGTTTAGGAAGAGGGGAGACCCAGTACTTC	CASGLGRGETQYF	TRBV12-5	TRBJ2-5
TGTGCCAGCAGCCAATACGGGACCAAAACTGCAGGGTTTTGTAACTATGGCTACACCTTC	CASSQYGTKTAGFCNYGYTF	TRBV3-1	TRBJ1-2
TGTGCCAGCAGCGTAGTAATGGGACCTTCCTACGAGCAGTACTTC	CASSVVMGPSYEQYF	TRBV9	TRBJ2-7
TGTGCCAGCAGCTTGGCCACGGACAGGGGCGGTCAGCCCCAGCATTTT	CASSLATDRGGQPQHF	TRBV5-4	TRBJ1-5
TGTGCCAGCAGTGGTAACGTGACTGGGGGAAACACCATATATTTT	CASSGNVTGGNTIYF	TRBV27	TRBJ1-3
TGCAGCGTCCACGCCGGGACCTTGATTTTTAGAGGGTCCTACAATGAGCAGTTCTTC	CSVHAGTLIFRGSYNEQFF	TRBV29-1	TRBJ2-1
TGTGCCAGCAGCGAACAGAGGAACACTGAAGCTTTCTTT	CASSEQRNTEAFF	TRBV9	TRBJ1-1
TGTGCTAGTGGTTTGGTACTCGACGGCGGGGAGCTAGCCAAAAACATTCAGTACTTC	CASGLVLDGGELAKNIQYF	TRBV12-5	TRBJ2-4
TGTGCCAGCAGTTGGGGCGGTTCCCAAGAGACCCAGTACTTC	CASSWGGSQETQYF	TRBV27	TRBJ2-5
TGTGCCAGCAGTACCGGACAGGGCCGAGGCTACACCTTC	CASSTGQGRGYTF	TRBV12-3	TRBJ1-2
TGTGCTAGTGGTTTGGTGTCCGGGGGCACGCGGTACGAGCAGTACTTC	CASGLVSGGTRYEQYF	TRBV12-5	TRBJ2-7
TGTGCCAGCAGTGCCCGGGGGGACGAGCAGTACTTC	CASSARGDEQYF	TRBV28	TRBJ2-7
TGTGCCAGCAGTTCAGCGGGAGTCTATCAGCCCCAGCATTTT	CASSSAGVYQPQHF	TRBV27	TRBJ1-5
TGTGCCTGGCCCGCCACCGGGACAGTGAACACTGAAGCTTTCTTT	CAWPATGTVNTEAFF	TRBV30	TRBJ1-1
TGTGCCAGCAGCCAAGTTAACCGGGACTATAACTATGGCTACACCTTC	CASSQVNRDYNYGYTF	TRBV4-2	TRBJ1-2
TGTGCCAGCAGCCTCTCGGGAGTACAGTACTTC	CASSLSGVQYF	TRBV7-9	TRBJ2-7
TGCAGCGTTGCTACAGGGGGTCCCGGCTCTGGAAACACCATATATTTT	CSVATGGPGSGNTIYF	TRBV29-1	TRBJ1-3
TGTGCCAGCAGTTCTTATCCGGACTACGAGCAGTACTTC	CASSSYPDYEQYF	TRBV6-5	TRBJ2-7
TGTGCCAGCAGCCCCAAGGACAGGGATGCCTACGAGCAGTACTTC	CASSPKDRDAYEQYF	TRBV9	TRBJ2-7
TGCGCCAGCAGCCACTGCGACTATGGCTACACCTTC	CASSHCDYGYTF	TRBV5-1	TRBJ1-2
TGTGCCAGCAGTGTAAGGGACAGGTTTATTTTTATGAACACTGAAGCTTTCTTT	CASSVRDRFIFMNTEAFF	TRBV6-6	TRBJ1-1
TGCAGTGCTAACCCTAGCCATCAGCCCCAGCATTTT	CSANPSHQPQHF	TRBV20-1	TRBJ1-5
TGTGCCAGCAGTGAAGGGAGGGCTTTCTTT	CASSEGRAFF	TRBV6-1	TRBJ1-1
TGCAGTGCTAGACACGCAGGGTGGGAGCGATGGCGAAACACCATATATTTT	CSARHAGWERWRNTIYF	TRBV20-1	TRBJ1-3
TGCAGTGCTGACACGCGGGGGAATCAGCCCCAGCATTTT	CSADTRGNQPQHF	TRBV20-1	TRBJ1-5
TGTGCCAGCAGTTACACAGGGGGGGGTTTGAACACTGAAGCTTTCTTT	CASSYTGGGLNTEAFF	TRBV27	TRBJ1-1
TGTGCCAGCAGGAACAAGGGGGCGGGTCAGCCCTCCGCTGGAAACACCATATATTTT	CASRNKGAGQPSAGNTIYF	TRBV3-1	TRBJ1-3
TGTGCCAGCAGTTTGGCCGCAATCAGTGCTAATGAAAAACTGTTTTTT	CASSLAAISANEKLFF	TRBV27	TRBJ1-4
TGTGCCAGCACCCAGACAGGGGGGTACGAGCAGTACTTC	CASTQTGGYEQYF	TRBV27	TRBJ2-7
TGCACCGGCACTCCAGTCTACGAGCAGTACTTC	CTGTPVYEQYF	TRBV20-1	TRBJ2-7
TGTGCCAGCAGTTTATCGAGGCGGGGGGCCATTGATACGCAGTATTTT	CASSLSRRGAIDTQYF	TRBV27	TRBJ2-3
TGTGCCAGAGAGGGGCGTCAGAACTATGGCTACACCTTC	CAREGRQNYGYTF	TRBV6-2	TRBJ1-2
TGTGCCAGCAGTGAGGATGGGCGACAGAAAGGGCTCGGGGAGCTGTTTTTT	CASSEDGRQKGLGELFF	TRBV6-3	TRBJ2-2
TGCAGTGCTCGGGGGACTGCTCGAGACGAGCAGTACTTC	CSARGTARDEQYF	TRBV20-1	TRBJ2-7
TGTGCCAGCTCACCACCCTTGGGACAGGGAGTACAAGAGACCCAGTACTTC	CASSPPLGQGVQETQYF	TRBV18	TRBJ2-5
TGTGCCAGCAGGCGACAGGGGCGCATGAACACTGAAGCTTTCTTT	CASRRQGRMNTEAFF	TRBV6-8	TRBJ1-1
TGTGCCAGCAGCAAACCTGTTTCTGAGAACACTGAAGCTTTCTTT	CASSKPVSENTEAFF	TRBV7-4	TRBJ1-1
TGTGCCAGCAGCGTCCCCCCCGGGACGTCGGGCTACGAGCAGTACTTC	CASSVPPGTSGYEQYF	TRBV7-3	TRBJ2-7
TGTGCCAGCAGTAACGGGACAGGTTCCCGACCTGAAGCTTTCTTT	CASSNGTGSRPEAFF	TRBV6-2	TRBJ1-1
TGCAGTGCTAACATCGGGGTATGGGAAAAACTGTTTTTT	CSANIGVWEKLFF	TRBV20-1	TRBJ1-4
TGTGCCAGCAGCGTTCGAGAGTTGTCCTACAATGAGCAGTTCTTC	CASSVRELSYNEQFF	TRBV7-6	TRBJ2-1
TGTGCCAGCAGCCGTTTAGAGGGGACAGGTGATGAGCAGTTCTTC	CASSRLEGTGDEQFF	TRBV7-9	TRBJ2-1
TGCACGCCCCCGGGACTAGCGGCTGGACGTGAGCAGTTCTTC	CTPPGLAAGREQFF	TRBV20-1	TRBJ2-1
TGCGCCAGCAGGGCACCTCAGGGCGGGGGTATCGGCCGGATCTCTGGGGCCAACGTCCTGACTTTC	CASRAPQGGGIGRISGANVLTF	TRBV5-1	TRBJ2-6
TGTGCCAGCAGCTCGGTTTATTCTGAAGCTTTCTTT	CASSSVYSEAFF	TRBV7-9	TRBJ1-1
TGTGCCAGCAGCTTAGGCCTCAGCACTGAAGCTTTCTTT	CASSLGLSTEAFF	TRBV11-3	TRBJ1-1
TGTGCCAGCAGCCAGGGTAGGTGGAACACTGAAGCTTTCTTT	CASSQGRWNTEAFF	TRBV7-2	TRBJ1-1
TGCGCCAGCGAGACAGAATGGGACCCGTCTTTTCCCCAGCATTTT	CASETEWDPSFPQHF	TRBV5-1	TRBJ1-5
TGTGCCACCAGTGATTTGAACTGGGCCGGGACAGGGCCGAACGGGGAGCTGTTTTTT	CATSDLNWAGTGPNGELFF	TRBV24-1	TRBJ2-2
TGTGCCAGCCAGACTAGGGCTATGCTCGATGAGCAGTTCTTC	CASQTRAMLDEQFF	TRBV6-1	TRBJ2-1
TGTGCCATCAGTGGCGGCAGGGCGCTCCCCTACAATGAGCAGTTCTTC	CAISGGRALPYNEQFF	TRBV10-3	TRBJ2-1
TGTGCCACCAGTGATAATGTCGGGACAGATGATCAGCCCCAGCATTTT	CATSDNVGTDDQPQHF	TRBV24-1	TRBJ1-5
TGCAGCGTTGATGGCCGGACAAGGGGGGGGACCGGGGAGCTGTTTTTT	CSVDGRTRGGTGELFF	TRBV29-1	TRBJ2-2
TGTGCCAGCAGTTACCGGACAGGATTAAGCTCCTACGAGCAGTACTTC	CASSYRTGLSSYEQYF	TRBV6-9	TRBJ2-7
TGTGCCAGCACCCGGACAGGGGGTCTTGATTCACCCCTCCACTTT	CASTRTGGLDSPLHF	TRBV7-9	TRBJ1-6
TGTGCCAGCCCCAACCGGGACAGGGGGGCCTCTGGAAACACCATATATTTT	CASPNRDRGASGNTIYF	TRBV7-9	TRBJ1-3
TGTGCCAGCAGCAACCAGGGGGCAACCGGGGAGCTGTTTTTT	CASSNQGATGELFF	TRBV7-3	TRBJ2-2
TGTGCCAGCAGCTTGACAATCACAGGGTTCCGGTACGAGCAGTACTTC	CASSLTITGFRYEQYF	TRBV5-4	TRBJ2-7
TGTGCCAGCAGCTTACTACGGGACGCTGAAAAACTGTTTTTT	CASSLLRDAEKLFF	TRBV7-2	TRBJ1-4
TGTGCCAGCAGCCTAGGACAGGAGTACGAGCAGTACTTC	CASSLGQEYEQYF	TRBV5-5	TRBJ2-7
TGCAGTGCTAGAGGAGTAGACAGGGGGGAGTACTTC	CSARGVDRGEYF	TRBV20-1	TRBJ2-7
TGTGCCAGCCAAACGTTCAGGGTATTTGCGACTGGGACAGATACGCAGTATTTT	CASQTFRVFATGTDTQYF	TRBV27	TRBJ2-3
TGTGCCAGCAGCAAGGGGGGCGGGAGCAATCAGCCCCAGCATTTT	CASSKGGGSNQPQHF	TRBV7-3	TRBJ1-5
TGTGCCAGCAGTCCCGGGGGGGATTCCTACGAGCAGTACTTC	CASSPGGDSYEQYF	TRBV28	TRBJ2-7
TGTGCCAGTAGTATGAGCGACATAGTCTTGTACACTGAAGCTTTCTTT	CASSMSDIVLYTEAFF	TRBV19	TRBJ1-1
TGCGCCAGCGCAACGGCGAATCAGCCCCAGCATTTT	CASATANQPQHF	TRBV10-1	TRBJ1-5
TGTGCCAGCAGTGCACCACTAGCGGGAGGCAGAGATACGCAGTATTTT	CASSAPLAGGRDTQYF	TRBV27	TRBJ2-3
TGTGCCAGCAGCTCCAGGACAGGGCCCGAGCAGTACTTC	CASSSRTGPEQYF	TRBV11-3	TRBJ2-7
TGTGCCAGCAGCTGTGTCCTATTCGGGCTAACCTATAGCAATCAGCCCCAGCATTTT	CASSCVLFGLTYSNQPQHF	TRBV7-3	TRBJ1-5
TGTGCCACCGAGCTAAACCGCAATCAGCCCCAGCATTTT	CATELNRNQPQHF	TRBV24-1	TRBJ1-5
TGTGCCAGCAGCCTAGCGGGGGGCTCCTACGAGCAGTACTTC	CASSLAGGSYEQYF	TRBV7-3	TRBJ2-7
TGCGCCAGCAGCCAAAGGTCGAGGGGGGGGGAGCAGTACTTC	CASSQRSRGGEQYF	TRBV4-3	TRBJ2-7
TGTGCCAGCGGGGGGGAGCGCATGAACACTGAAGCTTTCTTT	CASGGERMNTEAFF	TRBV11-3	TRBJ1-1
TGTGCCAGCAGCTTTGGGACAGGGGGCATGAACACTGAAGCTTTCTTT	CASSFGTGGMNTEAFF	TRBV27	TRBJ1-1
TGTGCCAGCAGTCCAGGGGGTCGAGGCTCTGGAAACACCATATATTTT	CASSPGGRGSGNTIYF	TRBV28	TRBJ1-3
TGTGCCAGCAGCCGGGACTCCTACAATGAGCAGTTCTTC	CASSRDSYNEQFF	TRBV28	TRBJ2-1
TGTGCCAGCAGCGCAGGCACGCAGGGGGGCGACTATGGCTACACCTTC	CASSAGTQGGDYGYTF	TRBV9	TRBJ1-2
TGTGCCAGCAGCTCCCCCATCCGGACAGGGAGCAATCAGCCCCAGCATTTT	CASSSPIRTGSNQPQHF	TRBV5-4	TRBJ1-5
TGTGCCAGCAGCGATAGATGGGGCACAGATACGCAGTATTTT	CASSDRWGTDTQYF	TRBV3-1	TRBJ2-3
TGTGCCAGCAGGTCAAACCCTTGGGACGTTTGCACAGATACGCAGTATTTT	CASRSNPWDVCTDTQYF	TRBV5-6	TRBJ2-3
TGTGCCAGCAGGTCTAGCGGGTCCTACGAGCAGTACTTC	CASRSSGSYEQYF	TRBV6-5	TRBJ2-7
TGTGCCTGGAGTGACATCGGGGGGGGGGTGTCCTTC	CAWSDIGGGVSF	TRBV30	TRBJ2-7
TGTGCCAGCAGCCAAGGGCTTTTTGAAGGGTGGGAGTTGAGTGGCTACACCTTC	CASSQGLFEGWELSGYTF	TRBV3-1	TRBJ1-2
TGTGCCAGCAGCGGTCCAGGGAGGGCAGATACGCAGTATTTT	CASSGPGRADTQYF	TRBV7-2	TRBJ2-3
TGTGCCAGCAGCCCATCTAGTAAGTACTCTGGAAACACCATATATTTT	CASSPSSKYSGNTIYF	TRBV6-1	TRBJ1-3
TGTGCCAGCAGCGCTGGGTGGTTCACAGATACGCAGTATTTT	CASSAGWFTDTQYF	TRBV5-8	TRBJ2-3
TGTGCCAGTAACGGTCTTGGGAAGCCCCAGCATTTT	CASNGLGKPQHF	TRBV19	TRBJ1-5
TGTGCCAGCAATGGGCCGGGACGGAATGAGCAGTTCTTC	CASNGPGRNEQFF	TRBV27	TRBJ2-1
TGTGCCAGCAGCGTAGTTACGCAAGAGAGGTATAGCAATCAGCCCCAGCATTTT	CASSVVTQERYSNQPQHF	TRBV9	TRBJ1-5
TGTGCCAGCAGTTACTCGTCCGCGGGAGGTAATCTGGATACGCAGTATTTT	CASSYSSAGGNLDTQYF	TRBV6-5	TRBJ2-3
TGTGCCAGCAGCTTAGCCGGGGACGCGCCCGAGCAGTTCTTC	CASSLAGDAPEQFF	TRBV7-9	TRBJ2-1
TGTGCCAGCAGTACCGACAGTGTCCCCGAAAAACTGTTTTTT	CASSTDSVPEKLFF	TRBV14	TRBJ1-4
TGTGCCAGTAGCAGGTCCCAGAACCTACCCCCCACTAGCGGGAGGGCGGGGGGCTACACCTTC	CASSRSQNLPPTSGRAGGYTF	TRBV19	TRBJ1-2
TGCAGTGCTAGAGATCCGGGGTACGAGCAGTACTTC	CSARDPGYEQYF	TRBV20-1	TRBJ2-7
TGTGCCAGCAGCTTCGCCGACAGGCAAGTTAACACTGAAGCTTTCTTT	CASSFADRQVNTEAFF	TRBV7-2	TRBJ1-1
TGTGCCAGCAGCTCACTAGCGGACAATGAGCAGTTCTTC	CASSSLADNEQFF	TRBV5-6	TRBJ2-1
TGTGCCTGGAGACGACTGAAAGAGACCCAGTACTTC	CAWRRLKETQYF	TRBV30	TRBJ2-5
TGCGCCAGCAGCCAAAACCTGGGGAACGAGCAGTACTTC	CASSQNLGNEQYF	TRBV4-1	TRBJ2-7
TGCGTGGCAGGGGGGGCAGGCACCGGGGAGCTGTTTTTT	CVAGGAGTGELFF	TRBV29-1	TRBJ2-2
TGTGCCAGCAGCCCGGTCGGGGAGTTTCTGGATCAGCCCCAGCATTTT	CASSPVGEFLDQPQHF	TRBV7-4	TRBJ1-5
TGTGCCAGCAGCGGCTCAAGGCGCAATCAGCCCCAGCATTTT	CASSGSRRNQPQHF	TRBV14	TRBJ1-5
TGCAGTGCTAGAGATGCCCGTCCACCTAGCGGGGCCCCAGATACGCAGTATTTT	CSARDARPPSGAPDTQYF	TRBV20-1	TRBJ2-3
TGTGCAACCTGGGGAGAAACCGGGGAGCTGTTTTTT	CATWGETGELFF	TRBV7-2	TRBJ2-2
TGCAGCGTTGAAGGGCCCCCGGACGCGACCTCCTACGAGCAGTACTTC	CSVEGPPDATSYEQYF	TRBV29-1	TRBJ2-7
TGTGCCTTTGGTGGAAGAGTAGGGCCGGACTACGAGCAGTACTTC	CAFGGRVGPDYEQYF	TRBV3-1	TRBJ2-7
TGTGCCAGCAGTTGGCGACAGGGCAAGGTGTGGGCAACAAAACTGTTTTTT	CASSWRQGKVWATKLFF	TRBV27	TRBJ1-4
TGCAGGTACAGACTCAGGGCAGGCTACACCTTC	CRYRLRAGYTF	TRBV29-1	TRBJ1-2
TGTGCCAGCAGTTACTCCCTCCGGACAGAACCCTATGGCTACACCTTC	CASSYSLRTEPYGYTF	TRBV6-6	TRBJ1-2
TGTGCCTGGAGTGCAAGTTCGGAGGGGCAGCCCCAGCATTTT	CAWSASSEGQPQHF	TRBV30	TRBJ1-5
TGTGCCAGCAGCCTGCTACAGGACCTCTTACGTAATGAAAAACTGTTTTTT	CASSLLQDLLRNEKLFF	TRBV7-3	TRBJ1-4
TGTGCCAGCAGACCAGGACAGCGAGGTAACTTT	CASRPGQRGNF	TRBV11-2	TRBJ1-1
TGTGCCAGCAGCCAAGATAGCATGGGGGACGAAATTCCAGGCACTCCGGACACCGGGGAGCTGTTTTTT	CASSQDSMGDEIPGTPDTGELFF	TRBV14	TRBJ2-2
TGTGCCAGCAGCCGACCCTACGAGCAGTACTTC	CASSRPYEQYF	TRBV5-4	TRBJ2-7
TGCAGTGCCACGGGGACTAGCGGGTCCTACGAGCAGTACTTC	CSATGTSGSYEQYF	TRBV20-1	TRBJ2-7
TGCAGTGCGGTACCGGGAGCCCTCCTTCGTTATGAGCAGTTCTTC	CSAVPGALLRYEQFF	TRBV20-1	TRBJ2-1
TGTGCCAGCAGCTTAGGTTCGGGACGGGTTGAAGATCAGCCCCAGCATTTT	CASSLGSGRVEDQPQHF	TRBV7-2	TRBJ1-5
TGTGCCAGCAGTTGTACACCCCGGATCTCAGAGAGACCCCGGACTGAAGCTTTCTTT	CASSCTPRISERPRTEAFF	TRBV6-8	TRBJ1-1
TGTGCCACCTGGGACAGGGATCTTGGCAATCAGCCCCAGCATTTT	CATWDRDLGNQPQHF	TRBV27	TRBJ1-5
TGCGCCAGCAGTGATCCGGGTGACCTCTATGGCTACACCTTC	CASSDPGDLYGYTF	TRBV10-1	TRBJ1-2
TGTGCCAGCAGTTCCCAGATCCCTATCGAAGAGCGGTACGAGCAGTACTTC	CASSSQIPIEERYEQYF	TRBV12-4	TRBJ2-7
TGTGCCAGCTCACGGGGGGCAGGCGGGAGAAGCGATACGCAGTATTTT	CASSRGAGGRSDTQYF	TRBV18	TRBJ2-3
TGTGCCAGCAGTTACGGGGGGACAGTTCCCCCCTACGAGCAGTACTTC	CASSYGGTVPPYEQYF	TRBV6-6	TRBJ2-7
TGCAGTGCTGGAGGGTTCAAGGCCCGTGAAAAACTGTTTTTT	CSAGGFKAREKLFF	TRBV20-1	TRBJ1-4
TGTGCCAGCAGCCAAGCTCTCGGGTACCCATGTTCCCCCCAGCCCCAGCATTTT	CASSQALGYPCSPQPQHF	TRBV3-1	TRBJ1-5
TGTGCCAGCAGCTTAGAGGGGAAGTATGGCTACACCTTC	CASSLEGKYGYTF	TRBV13	TRBJ1-2
TGTGCTAGTGGTTCAACCCGGGGGGCCAGGCTAGAAGAGACCCAGTACTTC	CASGSTRGARLEETQYF	TRBV12-5	TRBJ2-5
TGCGCCAGCAGCTCATTTCCCGGGGGGAGCACAGATACGCAGTATTTT	CASSSFPGGSTDTQYF	TRBV5-1	TRBJ2-3
TGTGCCAGCACCTCTAGCGGAGCCTACAATGAGCAGTTCTTC	CASTSSGAYNEQFF	TRBV6-4	TRBJ2-1
TGTGCCAGCAGCAGGGTTCGCGGGAGCCATGAGACCCAGTACTTC	CASSRVRGSHETQYF	TRBV5-4	TRBJ2-5
TGTGCCAGCCGATCGCATGGCCCTTACGAGCAGTACTTC	CASRSHGPYEQYF	TRBV9	TRBJ2-7
TGCAGTGCTAGCACCAAAAGGACTGAAGCTTTCTTT	CSASTKRTEAFF	TRBV20-1	TRBJ1-1
TGTGCCAGCAGGGATTGTGGTGTGAGGGGGGACTTATTCACTGAAGCTTTCTTT	CASRDCGVRGDLFTEAFF	TRBV6-4	TRBJ1-1
TGCGCCAGCAGCTTGGGGAGTAGCGGGGGAGACTACAATGAGCAGTTCTTC	CASSLGSSGGDYNEQFF	TRBV5-1	TRBJ2-1
TGTGCCACCAGTGATTTTTGGGGGATGCCTGAAGCTTTCTTT	CATSDFWGMPEAFF	TRBV24-1	TRBJ1-1
TGTGCCAGCAGCTTAAAGAGAAAAAGATTCGTCCGGGACAGGGTGGGCGAGGAAAAACTGTTTTTT	CASSLKRKRFVRDRVGEEKLFF	TRBV7-4	TRBJ1-4
TGTGCCAGCAGGGCTACAGGTACTAACGAGCAGTACTTC	CASRATGTNEQYF	TRBV28	TRBJ2-7
TGTGCCAGCAGTCTGACCCGGGCCGGAGGGGCGTACTACGAGCAGTACTTC	CASSLTRAGGAYYEQYF	TRBV27	TRBJ2-7
TGCGCCAGCAGCTGGGGCAACGCGGGGACAGGGTGTGAGCAGTACTTC	CASSWGNAGTGCEQYF	TRBV5-1	TRBJ2-7
TGTGCCAGCAGTGACCTTGGACAGGGGGCTTCGAGCTCCTACGAGCAGTACTTC	CASSDLGQGASSSYEQYF	TRBV6-4	TRBJ2-7
TGTGCCAGCAGCGACGCCGGGACAGAAGGAGGTTACTATGGCTACACCTTC	CASSDAGTEGGYYGYTF	TRBV7-7	TRBJ1-2
TGTGCCAGCAGTGAGACAGGGGTTTACACCGGGGAGCTGTTTTTT	CASSETGVYTGELFF	TRBV6-5	TRBJ2-2
TGTGCCAGCAGCCGTCACACTAATGAAAAACTGTTTTTT	CASSRHTNEKLFF	TRBV7-3	TRBJ1-4
TGTGCCAGCAGCTTAGGCCCGGAAATGGTTGCGCCGGGGGACACCGGGGAGCTGTTTTTT	CASSLGPEMVAPGDTGELFF	TRBV7-2	TRBJ2-2
TGTGCCAGCAGCTTGGACGATAGCGGGAACTCCTACGAGCAGTACTTC	CASSLDDSGNSYEQYF	TRBV7-9	TRBJ2-7
TGTGCCAGCCCGGGGGGGAGCGCCTACAATGAGCAGTTCTTC	CASPGGSAYNEQFF	TRBV2	TRBJ2-1
TGTGCCAGCAGTTTACTAGGTCCCCGGGGGGGCAGATTCAACACTGAAGCTTTCTTT	CASSLLGPRGGRFNTEAFF	TRBV28	TRBJ1-1
TGCGCCCGAGACAGCGACGAGCAGTACTTC	CARDSDEQYF	TRBV5-1	TRBJ2-7
TGTGCCAGCAGCCCGAGGGGTTCCCTCTACGAGCAGTACTTC	CASSPRGSLYEQYF	TRBV7-9	TRBJ2-7
TGTGCCAGCAGTGATGATATTCGCGACAGGGGGCGCTCCCAAGAGACCCAGTACTTC	CASSDDIRDRGRSQETQYF	TRBV6-1	TRBJ2-5
TGTGCCTGGAGTGTGGGACAGCGAAGGGCGAATGAAAAACTGTTTTTT	CAWSVGQRRANEKLFF	TRBV30	TRBJ1-4
TGTGCCAGCAGCGGCAGGGGGCCCTACGAGCAGTACTTC	CASSGRGPYEQYF	TRBV7-4	TRBJ2-7
TGTGCCAGCAGCCTTCGACATCCCACCGGGGAGCTGTTTTTT	CASSLRHPTGELFF	TRBV5-4	TRBJ2-2
TGCGCCAGCAGCTTGAACAGGGAAACCACGACAGGGGGCGAGTACGAGCAGTACTTC	CASSLNRETTTGGEYEQYF	TRBV5-1	TRBJ2-7
TGTGCCAGCAGCCTGCGGGGGGCCCCACTCTACGAGCAGTACTTC	CASSLRGAPLYEQYF	TRBV3-1	TRBJ2-7
TGCGCCAGCGGTATCCCCAGTGTAGCGGGGGTCATCTGCACAGATACGCAGTATTTT	CASGIPSVAGVICTDTQYF	TRBV4-1	TRBJ2-3
TGTGCCAGCTCAGGGGGGAGGGAAAGCTCCTACAATGAGCAGTTCTTC	CASSGGRESSYNEQFF	TRBV18	TRBJ2-1
TGCGCCAACAGGGCATATAGCAATCAGCCCCAGCATTTT	CANRAYSNQPQHF	TRBV5-1	TRBJ1-5
TGCAGGCTCAGGCTAGCGGGCAGCTACGAGCAGTACTTC	CRLRLAGSYEQYF	TRBV29-1	TRBJ2-7
TGTGCCAGCAGACAGGGAGGAGTGCGCACTGAAGCTTTCTTT	CASRQGGVRTEAFF	TRBV3-1	TRBJ1-1
TGTGCCAGCCCCAGGGGAGAGACCCAGTACTTC	CASPRGETQYF	TRBV6-1	TRBJ2-5
TGTGCCAGCAGCTTGAACCAGATCCACGAGCAGTACTTC	CASSLNQIHEQYF	TRBV11-3	TRBJ2-7
TGCAGTGCGAGAGGGGGGGCCGGGCATACGCAGTATTTT	CSARGGAGHTQYF	TRBV20-1	TRBJ2-3
TGTGCCAGCACCGCTCTTAATGAGGGGTTCGAGACCCAGTACTTC	CASTALNEGFETQYF	TRBV25-1	TRBJ2-5
TGTGCCTGGAGTGTCGATTGGGAGCAGCCCCAGCATTTT	CAWSVDWEQPQHF	TRBV30	TRBJ1-5
TGCAGTGCATGGGACATGTCGGATCAGCCCCAGCATTTT	CSAWDMSDQPQHF	TRBV20-1	TRBJ1-5
TGTGCCAGCAGCTACTTCCCGGGGGACGATTCACCCCTCCACTTT	CASSYFPGDDSPLHF	TRBV5-4	TRBJ1-6
TGCAGTGCTTTCCGACAGGGAGACGCCAAAAACATTCAGTACTTC	CSAFRQGDAKNIQYF	TRBV20-1	TRBJ2-4
TGTGCCAGCAGTTCAAAGTCCGGTTACGAGCAGTTCTTC	CASSSKSGYEQFF	TRBV28	TRBJ2-1
TGTGCCACCAGTACTGTAGGGGACAGTACTGAAGCTTTCTTT	CATSTVGDSTEAFF	TRBV24-1	TRBJ1-1
TGCAGTGCTAGAGAGCTCTTCTTCTCTGGAAACACCATATATTTT	CSARELFFSGNTIYF	TRBV20-1	TRBJ1-3
TGTGCCAGCAGTGACTGGCTACCCGGACGGATCTATGGCTACACCTTC	CASSDWLPGRIYGYTF	TRBV6-4	TRBJ1-2
TGTGCCGATCACATTCAGTACTTC	CADHIQYF	TRBV5-6	TRBJ2-4
TGTGCCAGCAGTTTTTGGGGACACCCCGGCTATGGCTACACCTTC	CASSFWGHPGYGYTF	TRBV12-3	TRBJ1-2
TGTGCCAGCAGCTTCGAGGGACAGGTTGAGTACAATGAGCAGTTCTTC	CASSFEGQVEYNEQFF	TRBV13	TRBJ2-1
TGCGCCAGCAGCTTGTGGTGGACAGGCGACACTGAAGCTTTCTTT	CASSLWWTGDTEAFF	TRBV5-1	TRBJ1-1
TGTGCCAGCAGCCAGGCGCCTATCCCCGAGACCCAGTACTTC	CASSQAPIPETQYF	TRBV13	TRBJ2-5
TGTGCCACCAGTGAGCAGGGCGGGAACACTGAAGCTTTCTTT	CATSEQGGNTEAFF	TRBV24-1	TRBJ1-1
TGTGCCAGCAGTTTCCCACGGGCTCACGAGCAGTACTTC	CASSFPRAHEQYF	TRBV12-4	TRBJ2-7
TGCAGTGCTCATGACAGGGGGGCTGGGGCCAACGTCCTGACTTTC	CSAHDRGAGANVLTF	TRBV20-1	TRBJ2-6
TGTGCCAGCAGCCAAGCAAGCGGGACCTACGAGCAGTACTTC	CASSQASGTYEQYF	TRBV3-1	TRBJ2-7
TGTGCCAGCAGTCCCCATATAGAAGATACGCAGTATTTT	CASSPHIEDTQYF	TRBV6-5	TRBJ2-3
TGTGCCAGCAGTGAAAAGCCCCGTGGCGGGCCCTACGAGCAGTACTTC	CASSEKPRGGPYEQYF	TRBV6-1	TRBJ2-7
TGTGCCAGCAGCTTGGGGCACTACGAGCAGTACTTC	CASSLGHYEQYF	TRBV7-6	TRBJ2-7
TGCAGTGCTAGAGCGAGCCCAGGGGATAATGAAAAACTGTTTTTT	CSARASPGDNEKLFF	TRBV20-1	TRBJ1-4
TGTGCCAGCAGGTCGAACCAAGAGACCCAGTACTTC	CASRSNQETQYF	TRBV27	TRBJ2-5
TGCGCCAGCAGACAGGAATATGGGCAGCCCCAGCATTTT	CASRQEYGQPQHF	TRBV10-1	TRBJ1-5
TGTGCCAGTAGTTGTAGCGGCCCGAACAATGAGCAGTTCTTC	CASSCSGPNNEQFF	TRBV19	TRBJ2-1
TGTGCCAGCAGTTACCGACAGGGGAATCAGCCCCAGCATTTT	CASSYRQGNQPQHF	TRBV6-5	TRBJ1-5
TGTGCCAGCAGTGACGTTCGACAGGGAGTGTGGAGCAATCAGCCCCAGCATTTT	CASSDVRQGVWSNQPQHF	TRBV6-4	TRBJ1-5
TGTGCTAGTGGTTTGGTAGAACGCTTTGGGACCTACGAGCAGTACTTC	CASGLVERFGTYEQYF	TRBV12-5	TRBJ2-7
TGTGCCAGCAGCCGGTGGCACTTGAACACCGGGGAGCTGTTTTTT	CASSRWHLNTGELFF	TRBV6-5	TRBJ2-2
TGTGCCAGCAGCCAGGGGGTAGCTAACTATGGCTACACCTTC	CASSQGVANYGYTF	TRBV11-2	TRBJ1-2
TGTGCCAGTAGTACCCCTCCTGACAGGGCGAGCACAGATACGCAGTATTTT	CASSTPPDRASTDTQYF	TRBV19	TRBJ2-3
TGTGCCCTAAGGACAGGGAGAGGTGCAACTAATGAAAAACTGTTTTTT	CALRTGRGATNEKLFF	TRBV30	TRBJ1-4
TGTGCCAGCAGTTACGTCAGGGGGGCTTCCCCTGGCTACACCTTC	CASSYVRGASPGYTF	TRBV6-5	TRBJ1-2
TGTGCCAGCAGCGGCGACAGGGCACCTAATGAAAAACTGTTTTTT	CASSGDRAPNEKLFF	TRBV11-1	TRBJ1-4
TGTGCCAGCAGCGACAGTCCCAATCAGCCCCAGCATTTT	CASSDSPNQPQHF	TRBV7-3	TRBJ1-5
TGCGCCAGCAGCCCAGCGCGGTATTTAACCTACGAGCAGTACTTC	CASSPARYLTYEQYF	TRBV5-1	TRBJ2-7
TGCGCCAGCAGCATTCAATGGGGGCCACGGAGCTCCTATAATTCACCCCTCCACTTT	CASSIQWGPRSSYNSPLHF	TRBV4-1	TRBJ1-6
TGTGCCAGTAGTCAGACAATCCGGGACAGGATTTCGAACACTGAAGCTTTCTTT	CASSQTIRDRISNTEAFF	TRBV19	TRBJ1-1
TGTGCCAGCAGTTACCCCCCAAGGGACAGGTTCCTTAATGAAAAACTGTTTTTT	CASSYPPRDRFLNEKLFF	TRBV6-5	TRBJ1-4
TGTGCCAGTGGCGGGGGGGGGATAGAGACCCAGTACTTC	CASGGGGIETQYF	TRBV19	TRBJ2-5
TGTGCCAGCAGCTCCCAAACTCGGGGCGGGGAGCTGTTTTTT	CASSSQTRGGELFF	TRBV7-9	TRBJ2-2
TGTGCCAACCCCACACAGGGGGGAAGCAATCAGCCCCAGCATTTT	CANPTQGGSNQPQHF	TRBV5-4	TRBJ1-5
TGTGCCAGCAGCCTGGGAAACAGGGGGCCTAGTAGCAATCAGCCCCAGCATTTT	CASSLGNRGPSSNQPQHF	TRBV4-2	TRBJ1-5
TGTGCCGCTAGGCGGGAGCAGTACTTC	CAARREQYF	TRBV10-3	TRBJ2-7
TGTGCCAGTAGTCGAGATAAGGGGCGGACTAGCGGCCAGAAGGGAGGCCTGGGGGAGACCCAGTACTTC	CASSRDKGRTSGQKGGLGETQYF	TRBV19	TRBJ2-5
TGTGCCAGCAGCCATCCCTTAGCAGGGACAGGGGTGATTTTCTATGGCTACACCTTC	CASSHPLAGTGVIFYGYTF	TRBV7-3	TRBJ1-2
TGTGCCAGCAGAACCCACGATAGACTTGAAAAACTGTTTTTT	CASRTHDRLEKLFF	TRBV2	TRBJ1-4
TGTGCCAGCAGGAAGCCCGGGAATGGCTACACCTTC	CASRKPGNGYTF	TRBV7-6	TRBJ1-2
TGTGCCAGCAGTAACGGGGGGAGCGAGCAGTACTTC	CASSNGGSEQYF	TRBV6-4	TRBJ2-7
TGTGCCAGCATAGCGGCTAGAGACGAGCAGTACTTC	CASIAARDEQYF	TRBV27	TRBJ2-7
TGCAGTGCTAGAGAGGCGCCGGGACAGGATGGGACATTTCAATCCAGCAATCAGCCCCAGCATTTT	CSAREAPGQDGTFQSSNQPQHF	TRBV20-1	TRBJ1-5
TGCGCCAGCAGCTTTTATCCCCGGGGACATGAGACCCAGTACTTC	CASSFYPRGHETQYF	TRBV5-1	TRBJ2-5
TGTGCCAGCAGCCATTGGGGACAGAGCAATCAGCCCCAGCATTTT	CASSHWGQSNQPQHF	TRBV7-2	TRBJ1-5
TGTGCCAGCAGCCAAGTAACAAAGCCTGAAAAACTGTTTTTT	CASSQVTKPEKLFF	TRBV3-1	TRBJ1-4
TGTGCCAGCATTATCCCCGGGACAGGGCTGAACTATGGCTACACCTTC	CASIIPGTGLNYGYTF	TRBV7-9	TRBJ1-2
TGTGCCAGCAGTGACACGTACGGGGAGGGCTACACCTTC	CASSDTYGEGYTF	TRBV6-4	TRBJ1-2
TGCAGCGTTGGGATTGGGGGGGACGAGCAGTACTTC	CSVGIGGDEQYF	TRBV29-1	TRBJ2-7
TGCAGTAATCACGGACAGGGGGGAAACACCGGGGAGCTGTTTTTT	CSNHGQGGNTGELFF	TRBV20-1	TRBJ2-2
TGTGCCAGCAGCTCGGGAGCGTACAATGAGCAGTTCTTC	CASSSGAYNEQFF	TRBV5-4	TRBJ2-1
TGTGCTAGTGGTAGAACGTTTAAAGACACTGAAGCTTTCTTT	CASGRTFKDTEAFF	TRBV12-5	TRBJ1-1
TGCAGTGCTACCCCCCGTTCAGGACGTGGCTACACCTTC	CSATPRSGRGYTF	TRBV20-1	TRBJ1-2
TGTGCCTGGCCTGTTTACGAGCAGTACTTC	CAWPVYEQYF	TRBV30	TRBJ2-7
TGTGCCAGCAGCTCCCCAGACAGGGGTGAAAAACTGTTTTTT	CASSSPDRGEKLFF	TRBV7-3	TRBJ1-4
TGCGCCAGCAGCGCCAGACGCCCAGCGAACACCGGGGAGCTGTTTTTT	CASSARRPANTGELFF	TRBV5-1	TRBJ2-2
TGTGCCAGCAGCTTAAAGGAAGTGCAGGTCTATGAAAAACTGTTTTTT	CASSLKEVQVYEKLFF	TRBV7-2	TRBJ1-4
TGTGCCAGGGGGGGCGGATGGGATACGCAGTATTTT	CARGGGWDTQYF	TRBV6-8	TRBJ2-3
TGTGCCAGCAGTTTACCCCCGGGACAGATGCGCTACGAGCAGTACTTC	CASSLPPGQMRYEQYF	TRBV28	TRBJ2-7
TGTGCCAGCAGCATGGGACGGTTCCCCGCCTTTTATACGCAGTATTTT	CASSMGRFPAFYTQYF	TRBV13	TRBJ2-3
TGTGCCAGCAGTTTCGCCACAGGGAGGGCCGGGGAGCTGTTTTTT	CASSFATGRAGELFF	TRBV12-4	TRBJ2-2
TGTGCCAGCAGCTTAGCCGGTAATCTCGGTGAAAAACTGTTTTTT	CASSLAGNLGEKLFF	TRBV7-2	TRBJ1-4
TGCGCCAGCAGCTTGGCCCCATCGGGACTCGGCTACACCTTC	CASSLAPSGLGYTF	TRBV5-1	TRBJ1-2
TGTGCCAGCGAGCAGGGATATAGCAATCAGCCCCAGCATTTT	CASEQGYSNQPQHF	TRBV25-1	TRBJ1-5
TGTGCCAGCAGCTATTCACTCAACCCTCGGTCGAATTCACCCCTCCACTTT	CASSYSLNPRSNSPLHF	TRBV7-3	TRBJ1-6
TGTGCTCCTCCAGGGACAGGGCCTACACTCTACACTGAAGCTTTCTTT	CAPPGTGPTLYTEAFF	TRBV6-2	TRBJ1-1
TGCGCCAGCAGCCAAGAAGGCGGGGGGGAACGGGCTGAAGCTTTCTTT	CASSQEGGGERAEAFF	TRBV4-1	TRBJ1-1
TGCAGCGCAGGGGAAAAGAACTATGGCTACACCTTC	CSAGEKNYGYTF	TRBV29-1	TRBJ1-2
TGTGCCAGCAGCTTAGCAGATGGCTATAGGACAGGGGGCGATATGAACACTGAAGCTTTCTTT	CASSLADGYRTGGDMNTEAFF	TRBV7-4	TRBJ1-1
TGTCTTCACCATAGGCCCCCAAAACTGTTTTTT	CLHHRPPKLFF	TRBV27	TRBJ1-4
TGTGCCAGCAGTTACACCGTCCTGGGACAGTCAGGTGAAGAGACCCAGTACTTC	CASSYTVLGQSGEETQYF	TRBV6-5	TRBJ2-5
TGCGCCAGCAGCTTGGTGTTCCCGGTCCTTCGGGGACAGCGTTCCTACGAGCAGTACTTC	CASSLVFPVLRGQRSYEQYF	TRBV5-1	TRBJ2-7
TGTGCCAGCAGCTTAATCCAGACAGGGGGGCAGACCCAGTACTTC	CASSLIQTGGQTQYF	TRBV7-3	TRBJ2-5
TGTGCCACCAAATCGACTTTTCAGCCCCAGCATTTT	CATKSTFQPQHF	TRBV24-1	TRBJ1-5
TGTGCCAGCTCACCCTCAGGGTTCAGCTCCTACAATGAGCAGTTCTTC	CASSPSGFSSYNEQFF	TRBV18	TRBJ2-1
TGTGCCTGCCGGGGGGCCGGGGAGCTGTTTTTT	CACRGAGELFF	TRBV9	TRBJ2-2
TGTGCCAGCAGCTTAGCCCGGAGCGGGACCCCTAGAGAGACCCAGTACTTC	CASSLARSGTPRETQYF	TRBV11-1	TRBJ2-5
TGTGCCAGCATGTTAGTAGGAGACGTAAACACCGGGGAGCTGTTTTTT	CASMLVGDVNTGELFF	TRBV7-9	TRBJ2-2
TGTGCCAGCAGCTCGGTGAGCGGGAAGGGGGATCCCTACGAGCAGTACTTC	CASSSVSGKGDPYEQYF	TRBV11-1	TRBJ2-7
TGTGCCAGCAGTTACGGGACTAGCGTTAGCTCCTACAATGAGCAGTTCTTC	CASSYGTSVSSYNEQFF	TRBV6-5	TRBJ2-1
TGTGCCAGCTCACCACCCCCAGGGTCTAGAGGGGATGAAAAACTGTTTTTT	CASSPPPGSRGDEKLFF	TRBV18	TRBJ1-4
TGTGCCAGCAGCCAAGCGACAGGGGGCTTCGCCAATGAGCAGTTCTTC	CASSQATGGFANEQFF	TRBV14	TRBJ2-1
TGTGCCAGCAGCTTACTAGCCCAGGGGGATGGCTACACCTTC	CASSLLAQGDGYTF	TRBV11-3	TRBJ1-2
TGTGCCAGCAGTTACTTAGCACTAGCGGGAGTCCAAAACATTCAGTACTTC	CASSYLALAGVQNIQYF	TRBV6-3	TRBJ2-4
TGCAGTGCTCTTAGGGCGGATGGAAACACCATATATTTT	CSALRADGNTIYF	TRBV20-1	TRBJ1-3
TGTGCCAGCAGTTGGGAGGGGGGGGGCTCTTACGAGCAGTACTTC	CASSWEGGGSYEQYF	TRBV28	TRBJ2-7
TGTGCCAGCAGCCAGAGCGGCGGAAACTCCTACGAGCAGTACTTC	CASSQSGGNSYEQYF	TRBV3-1	TRBJ2-7
TGTGCCAGCAGCCAGCAAACCCTAGCGGGGGCAGATACGCAGTATTTT	CASSQQTLAGADTQYF	TRBV14	TRBJ2-3
TGTGCCACCCCCTGGGATGAGCAGTTCTTC	CATPWDEQFF	TRBV6-4	TRBJ2-1
TGTGCCAGCAGTTTATTTAGGACAGGGGCCTACAATGAGCAGTTCTTC	CASSLFRTGAYNEQFF	TRBV27	TRBJ2-1
TGTGCCATCAGTGACGTCGGCATCACGGAGGCAACTAATGAAAAACTGTTTTTT	CAISDVGITEATNEKLFF	TRBV10-3	TRBJ1-4
TGCGCCAGCAGGAGGGAGCGCTCCTACAATGAGCAGTTCTTC	CASRRERSYNEQFF	TRBV4-3	TRBJ2-1
TGTGCCAGCATTAAGGGGGCCCCGAACACCGGGGAGCTGTTTTTT	CASIKGAPNTGELFF	TRBV6-1	TRBJ2-2
TGTGCCAGCTCACCAGCCCCCGGGGCAGATAATTCACCCCTCCACTTT	CASSPAPGADNSPLHF	TRBV18	TRBJ1-6
TGTGCCAGCAGCCTGAGGGGAGCCAAAAACATTCAGTACTTC	CASSLRGAKNIQYF	TRBV13	TRBJ2-4
TGTGCCAGCAAGAAGGCCGGCCTGGGGGCGGGGGACTCTGGGGCCAACGTCCTGACTTTC	CASKKAGLGAGDSGANVLTF	TRBV27	TRBJ2-6
TGTGCCAGCAGACCGACAGGTTACCAAGAGACCCAGTACTTC	CASRPTGYQETQYF	TRBV5-4	TRBJ2-5
TGTGCCAGCAGCCTTAGGGGCCACGGCACCATATATTTT	CASSLRGHGTIYF	TRBV13	TRBJ1-3
TGTGCCAGCAGCTTAACGACTTCGACTAGCGGGAGGTGCCTCGGCAGGGGGTCCACTGAAGCTTTCTTT	CASSLTTSTSGRCLGRGSTEAFF	TRBV7-3	TRBJ1-1
TGTGCCAGCAGTTTGGCAAGGAAGAGACTCTGCACAGATACGCAGTATTTT	CASSLARKRLCTDTQYF	TRBV12-4	TRBJ2-3
TGCAAGTTGAACGGCGGGACTCTCAATGAAAAACTGTTTTTT	CKLNGGTLNEKLFF	TRBV20-1	TRBJ1-4
TGTGCCAGCAGTTATGGCTTCCCGGGACAGGTGTTCTATAATTCACCCCTCCACTTT	CASSYGFPGQVFYNSPLHF	TRBV6-3	TRBJ1-6
TGTGCCAGCAGCTTAGGTCCAGGGGCCGAGAACACTGAAGCTTTCTTT	CASSLGPGAENTEAFF	TRBV11-2	TRBJ1-1
TGCGCCAGCAGCCCCATGGGGCAGCCCCAGCATTTT	CASSPMGQPQHF	TRBV5-1	TRBJ1-5
TGTGCCAGCAGCCCGAAAAGGGTGATGTCTGAAGCTTTCTTT	CASSPKRVMSEAFF	TRBV7-9	TRBJ1-1
TGTGCCAGCAGTTCACGGAGTTTCCAGAGCGGGAACACTGAAGCTTTCTTT	CASSSRSFQSGNTEAFF	TRBV6-6	TRBJ1-1
TGTGCCAGCAGTGTTCGGGGGGGGGGTACCTTCGAGCAGTTCTTC	CASSVRGGGTFEQFF	TRBV6-4	TRBJ2-1
TGTGCCAGCAGGTACCGGGACAGGGGGGGAGATGGCTACACCTTC	CASRYRDRGGDGYTF	TRBV7-3	TRBJ1-2
TGTGCCAGCAGCCCCCGGGTCCCTGAGCAGTTCTTC	CASSPRVPEQFF	TRBV7-3	TRBJ2-1
TGTGCCAGCAGCGGACGGACTAGACCAGATACGCAGTATTTT	CASSGRTRPDTQYF	TRBV5-5	TRBJ2-3
TGTGCCAGCAGTTACGGCCGGCTACAGGGGTCTGGGGCCAACGTCCTGACTTTC	CASSYGRLQGSGANVLTF	TRBV6-5	TRBJ2-6
TGTGCCAGCAGCTTGGACAGAAGAGATAGCAATCAGCCCCAGCATTTT	CASSLDRRDSNQPQHF	TRBV16	TRBJ1-5
TGTGCCAGTACCTCCGGGGCCACAGATACGCAGTATTTT	CASTSGATDTQYF	TRBV19	TRBJ2-3
TGCGCCAGCAGGACAGGTAGCTCTGGAAACACCATATATTTT	CASRTGSSGNTIYF	TRBV10-1	TRBJ1-3
TGCAGTGCTAGAGCACGTGGGACCTATGGCTACACCTTC	CSARARGTYGYTF	TRBV20-1	TRBJ1-2
TGTGCCAGCAGCTTAGATGCTGTGGACAACTGCACTGAAGCTTTCTTT	CASSLDAVDNCTEAFF	TRBV11-2	TRBJ1-1
TGTGCCAGCAGCCGGAAATGCGGGAGCGGCGCTGGAGGAAACACCATATATTTT	CASSRKCGSGAGGNTIYF	TRBV14	TRBJ1-3
TGTGCCATGCCCTATAGGACAGAAGGCAATCAGCCCCAGCATTTT	CAMPYRTEGNQPQHF	TRBV2	TRBJ1-5
TGTGCCACCCTAGCCCCCAGGACAGACACCGGGGAGCTGTTTTTT	CATLAPRTDTGELFF	TRBV24-1	TRBJ2-2
TGTGCCAGCAGCTTAGTTCTGTGGGACAGCGCCGAGCAGTACTTC	CASSLVLWDSAEQYF	TRBV11-2	TRBJ2-7
TGTGCCAGCAGCTTGAACCCAGGGGGGGGAAAGACCTACGAGCAGTACTTC	CASSLNPGGGKTYEQYF	TRBV5-4	TRBJ2-7
TGTGCCAGCACCAGGGGGCGCTTGGACGAGCAGTACTTC	CASTRGRLDEQYF	TRBV25-1	TRBJ2-7
TGTGCCAGCAGCCTTCCGGGACTTGCCTACGAGCAGTACTTC	CASSLPGLAYEQYF	TRBV3-1	TRBJ2-7
TGTGCTAGCAGCCCCTACCTACGGACGAACACTGAAGCTTTCTTT	CASSPYLRTNTEAFF	TRBV7-7	TRBJ1-1
TGTGCCAGCAGCGTGAAGCCCACTAGCGGGAGGGCAGGCGACTCCTACGAGCAGTACTTC	CASSVKPTSGRAGDSYEQYF	TRBV13	TRBJ2-7
TGTGCCAGCACCGGTCCGGGACAGGGCCTGAAGAGCACCGGGGAGCTGTTTTTT	CASTGPGQGLKSTGELFF	TRBV11-3	TRBJ2-2
TGCGCCAGCAGCTTACGGGGAAGGCCCTACGAGCAGTACTTC	CASSLRGRPYEQYF	TRBV5-1	TRBJ2-7
TGTGCCAGCAGTGACAGACTCCGCCGGGACACCGGGGAGCTGTTTTTT	CASSDRLRRDTGELFF	TRBV6-4	TRBJ2-2
TGTGCCAGCAGTAAAGAACGGGACAAGTTAAATTCACCCCTCCACTTT	CASSKERDKLNSPLHF	TRBV6-5	TRBJ1-6
TGTGCCAGCAGCAACCCGCGCGGGGGCCCCTACAATGAGCAGTTCTTC	CASSNPRGGPYNEQFF	TRBV5-6	TRBJ2-1
TGTGCCAGCAAGGAACGGGGGGTCGCAGATCAGCCCCAGCATTTT	CASKERGVADQPQHF	TRBV6-4	TRBJ1-5
TGTGCCAGCAGTTTCGGTTCCCCACGCGGTACACAGGGGAGCAACTCTGGAAACACCATATATTTT	CASSFGSPRGTQGSNSGNTIYF	TRBV27	TRBJ1-3
TGTGCCAGCAGCACCCCCCGGGACAGAGGAAACACCATATATTTT	CASSTPRDRGNTIYF	TRBV11-3	TRBJ1-3
TGCAGCGTTGATTCCGTGGTTGGGGGGGACCCCTCTGGAAACACCATATATTTT	CSVDSVVGGDPSGNTIYF	TRBV29-1	TRBJ1-3
TGTGCCACCAGCCCCACAGGGCCCAAGGAAGAGACCCAGTACTTC	CATSPTGPKEETQYF	TRBV24-1	TRBJ2-5
TGCGCCAGCACAAAGGGGAGTCGATCCAATGAGCAGTTCTTC	CASTKGSRSNEQFF	TRBV4-1	TRBJ2-1
TGCAGCGTTGAACCTGGCGGAGGACAGGGGGGCCGGGGGACTGAAGCTTTCTTT	CSVEPGGGQGGRGTEAFF	TRBV29-1	TRBJ1-1
TGTGCCAGCAGTGGACGTCAGAACAGGAGTTACCAAGAGACCCAGTACTTC	CASSGRQNRSYQETQYF	TRBV12-4	TRBJ2-5
TGTGCCAGCAGCAGGAGCCCTCCCCGCCAGGGGGCAAGCCCGAAAGTCCGCACAGATACGCAGTATTTT	CASSRSPPRQGASPKVRTDTQYF	TRBV13	TRBJ2-3
TGTGCCAGCAGCCCAGGGGGTCCCCTTAATCAGCCCCAGCATTTT	CASSPGGPLNQPQHF	TRBV4-2	TRBJ1-5
TGTGCCAGCAGCAGACCGGCGAAGCTAGTTATATATGGCTCCTACAATGAGCAGTTCTTC	CASSRPAKLVIYGSYNEQFF	TRBV7-2	TRBJ2-1
TGTGCCAGCAGTGCGATTAAACAAGAGACCCAGTACTTC	CASSAIKQETQYF	TRBV7-8	TRBJ2-5
TGTGCCAGCAGGTCACAGGGGACACAGGTTAGCAATCAGCCCCAGCATTTT	CASRSQGTQVSNQPQHF	TRBV12-4	TRBJ1-5
TGTGCCAGCAGCCGACTAGCGGGCACCGGGGAGCTGTTTTTT	CASSRLAGTGELFF	TRBV3-1	TRBJ2-2
TGTGCCAGCAGTTACTCCACAGCCTCCTACGAGCAGTACTTC	CASSYSTASYEQYF	TRBV6-3	TRBJ2-7
TGTGCCAGTAAAACCTTAGGCACCGGGGAGCTGTTTTTT	CASKTLGTGELFF	TRBV6-1	TRBJ2-2
TGCGCCAGCAGCATCGCGAGGGGGGCTGGAAACACCATATATTTT	CASSIARGAGNTIYF	TRBV10-1	TRBJ1-3
TGTGCCAGCACGGAACAGTTCTCTGGAAACACCATATATTTT	CASTEQFSGNTIYF	TRBV6-4	TRBJ1-3
TGTGCCAGCGGAGGGTGTTGGACTAGCGGGAGAGACAATGAGCAGTTCTTC	CASGGCWTSGRDNEQFF	TRBV27	TRBJ2-1
TGTGCTAGTTGGACGAAGGCCGGGGAGCTGTTTTTT	CASWTKAGELFF	TRBV12-5	TRBJ2-2
TGTGCCAGCAGTCAAGCTCAATCAGGGGGATATGGCTACACCTTC	CASSQAQSGGYGYTF	TRBV27	TRBJ1-2
TGTGCCAGCAGCCGGGCCGGCCAAGAGACCCAGTACTTC	CASSRAGQETQYF	TRBV27	TRBJ2-5
TGTGCCAGCCGACTAGCGGGCGATACGCAGTATTTT	CASRLAGDTQYF	TRBV6-1	TRBJ2-3
TGTGCCAGCAGCAGGCCGCGCAATGAGCAGTTCTTC	CASSRPRNEQFF	TRBV6-2	TRBJ2-1
TGCGCCAGCAAGTTATTTTGCCGGGACAGGGGTTATATGGGGGCCTACGAGCAGTACTTC	CASKLFCRDRGYMGAYEQYF	TRBV10-1	TRBJ2-7
TGTGCCAGCAGAGGGGCGAAGACCCAGTACTTC	CASRGAKTQYF	TRBV5-4	TRBJ2-5
TGTGCCAGCAGTTTTATGGTTAAGGAGTCTTCCTACAATGAGCAGTTCTTC	CASSFMVKESSYNEQFF	TRBV12-3	TRBJ2-1
TGCGCCATTTGCGGGAGCGGCTACACCTTC	CAICGSGYTF	TRBV5-1	TRBJ1-2
TGTGCCAGCAGCTGGACAGGGGGGGAGAACACTGAAGCTTTCTTT	CASSWTGGENTEAFF	TRBV5-4	TRBJ1-1
TGCGCCAGCGGGGGACCCGTTGAAAAACTGTTTTTT	CASGGPVEKLFF	TRBV10-1	TRBJ1-4
TGTGCCATCATCGGCGGGCTAAACTACGAGCAGTACTTC	CAIIGGLNYEQYF	TRBV10-3	TRBJ2-7
TGTGCCTGGAGTGCGACGCGGAACACCGGGGAGCTGTTTTTT	CAWSATRNTGELFF	TRBV30	TRBJ2-2
TGCAGCGCGGGGAGGGGGCAGTACGAGCAGTACTTC	CSAGRGQYEQYF	TRBV29-1	TRBJ2-7
TGTGCCAGCAGCTTACTCGGGGACAGATTCTATGGCTACACCTTC	CASSLLGDRFYGYTF	TRBV7-3	TRBJ1-2
TGTGCCAGCAGTTCCCAAGGGACTAGCGGGATAGGTCAAGAGACCCAGTACTTC	CASSSQGTSGIGQETQYF	TRBV6-5	TRBJ2-5
TGTGCCAGTAGTAAGACGACAGAATCCTACGAGCAGTACTTC	CASSKTTESYEQYF	TRBV19	TRBJ2-7
TGTGCCAGCAGTCTGGGACGGAACTCCGGGGAGCTGTTTTTT	CASSLGRNSGELFF	TRBV27	TRBJ2-2
TGTGCCAGCAGCCCAAGGGCCACCGGGACCGAGACCCAGTACTTC	CASSPRATGTETQYF	TRBV14	TRBJ2-5
TGTGCCAGCAGTGTAGCAGGGGGCGGCTACGAGCAGTACTTC	CASSVAGGGYEQYF	TRBV27	TRBJ2-7
TGTGCCAGCAGTGAACGGTGGGGGGAGGTCTACAATGAGCAGTTCTTC	CASSERWGEVYNEQFF	TRBV2	TRBJ2-1
TGCGCCAGCAGCTTAGCTAAAACTAGAGCGGGACAAGAGACCCAGTACTTC	CASSLAKTRAGQETQYF	TRBV5-1	TRBJ2-5
TGTGCCAGCCCGGGTGGGGAAATAAGCAATCAGCCCCAGCATTTT	CASPGGEISNQPQHF	TRBV6-4	TRBJ1-5
TGTGCCAGCAGTTTACAGCTAGCGGATGCGGAGACCCAGTACTTC	CASSLQLADAETQYF	TRBV12-4	TRBJ2-5
TGCGCCAGCGGACAGTTCACCTACGAGCAGTACTTC	CASGQFTYEQYF	TRBV10-2	TRBJ2-7
TGTGCCAGCAGTATGGCGACTAGCACAGATACGCAGTATTTT	CASSMATSTDTQYF	TRBV28	TRBJ2-3
TGTGGAAGTGCTTTTCTTTCCAGGGACCGACACCCACGGAGGGCTTTCTTT	CGSAFLSRDRHPRRAFF	TRBV27	TRBJ1-1
TGTGCCAGCAGTTTCGCCCGACGTGACAGGGAGGGCTACACCTTC	CASSFARRDREGYTF	TRBV28	TRBJ1-2
TGTGCCAGCAGGGGGGGATCTACTGAAGCTTTCTTT	CASRGGSTEAFF	TRBV28	TRBJ1-1
TGTGCCAGCAGCTTGGGTACTAGGTTTTCCGAGACCCAGTACTTC	CASSLGTRFSETQYF	TRBV5-4	TRBJ2-5
TGTGCCAGCAGACCGATAAGTCGGCGTCCGTTCGAGCAGTACTTC	CASRPISRRPFEQYF	TRBV13	TRBJ2-7
TGTGCCAGCAGACAGGGGTTACAGGGTTTGGATACGCAGTATTTT	CASRQGLQGLDTQYF	TRBV7-3	TRBJ2-3
TGTGCCAGCAGCCAAAGCCTAGACAATGGGGAGGATGGCTACACCTTC	CASSQSLDNGEDGYTF	TRBV7-4	TRBJ1-2
TGTGCCAGCAGCGTAGCCCGGACCTACGAGCAGTACTTC	CASSVARTYEQYF	TRBV9	TRBJ2-7
TGTGCCAGCATAGGGTCGGCCTACAATGAGCAGTTCTTC	CASIGSAYNEQFF	TRBV14	TRBJ2-1
TGCGCCAGCATCCCCCTAGCGGGCCAGGCCTACGAGCAGTACTTC	CASIPLAGQAYEQYF	TRBV10-2	TRBJ2-7
TGCAGTGTCTATGGGGTCGATTCCATAATGAACACTGAAGCTTTCTTT	CSVYGVDSIMNTEAFF	TRBV20-1	TRBJ1-1
TGTGCCAGCTTGTTCACAAATAGGGAAAAACTGTTTTTT	CASLFTNREKLFF	TRBV9	TRBJ1-4
TGTGCCTGGAGAAGGTCGGATACGCAGTATTTT	CAWRRSDTQYF	TRBV30	TRBJ2-3
TGTGCCAGCAGTGACGGGGGGAGTACCCAAGAGACCCAGTACTTC	CASSDGGSTQETQYF	TRBV2	TRBJ2-5
TGTGCCGGACTAGCGGGTAACCCCGAGCAGTACTTC	CAGLAGNPEQYF	TRBV19	TRBJ2-7
TGTGCTAGTGGTTTGGTAAGGGCGACCGGGGCCAACGTCCTGACTTTC	CASGLVRATGANVLTF	TRBV12-5	TRBJ2-6
TGTGCCAGTAGTATTATCCCCCTAGCGGGCGAGACCCAGTACTTC	CASSIIPLAGETQYF	TRBV19	TRBJ2-5
TGTGCCACCAGTGACCCGAATAATGAGCAGTTCTTC	CATSDPNNEQFF	TRBV24-1	TRBJ2-1
TGCAGTGCAAGGGGGGGACAGGTTTTCTCTGGGGCCAACGTCCTGACTTTC	CSARGGQVFSGANVLTF	TRBV20-1	TRBJ2-6
TGTGCCAGCAGCCAAGTCGGAGGACTAGCGATGTACCAAGAGACCCAGTACTTC	CASSQVGGLAMYQETQYF	TRBV4-2	TRBJ2-5
TGTGCCAGCAGGACTAGCGGCACAGATACGCAGTATTTT	CASRTSGTDTQYF	TRBV6-4	TRBJ2-3
TGTGCCAGCAGCTTACTGCCCCAGGGCTACAATGAGCAGTTCTTC	CASSLLPQGYNEQFF	TRBV7-6	TRBJ2-1
TGTGCCATATACAGACGGGAGAATGAAGCTTTCTTT	CAIYRRENEAFF	TRBV6-5	TRBJ1-1
TGTGCCAGCAGCTTAGATCCGCCGGGTCCGCACAATGAGCAGTTCTTC	CASSLDPPGPHNEQFF	TRBV13	TRBJ2-1
TGCGCCAGCAGCCAAGTGTATTCGCATGAGCAGTTCTTC	CASSQVYSHEQFF	TRBV4-1	TRBJ2-1
TGTGCCAGCAGCTACCGTCGAGAGAGGTACCGGGGGGTCTCCCGCCGGTCCGGGGAGCTGTTTTTT	CASSYRRERYRGVSRRSGELFF	TRBV11-3	TRBJ2-2
TGTGCCAGCAGCTTAAGGACCGTCCTAGCGGGGAACATTCAGTACTTC	CASSLRTVLAGNIQYF	TRBV7-9	TRBJ2-4
TGTGCCAGCAGCCAAGAGACAGGGGAATGGAACACTGAAGCTTTCTTT	CASSQETGEWNTEAFF	TRBV5-8	TRBJ1-1
TGTGCCAGCAGCTTAGAACTAGGGCGCCTTGGACAGGGCCCGAATGAAAAACTGTTTTTT	CASSLELGRLGQGPNEKLFF	TRBV11-3	TRBJ1-4
TGTGCCCAGGCCGGGACGTACGAGCAGTACTTC	CAQAGTYEQYF	TRBV11-3	TRBJ2-7
TGCAGTGCTAGGGCAAGCCATAGAGGGACAGACGGGCAAGGGGGCTACACCTTC	CSARASHRGTDGQGGYTF	TRBV20-1	TRBJ1-2
TGTGCCAGCAGTAGAGACCCGGGAGAAGCTGAAGCTTTCTTT	CASSRDPGEAEAFF	TRBV6-1	TRBJ1-1
TGTGCCAGCAGCCTGGGGGGCCGCAATCAGCCCCAGCATTTT	CASSLGGRNQPQHF	TRBV7-2	TRBJ1-5
TGTGCCAGCAGCCAAAAGGGACAGGGGGCGAGGGTCATCTATGGCTACACCTTC	CASSQKGQGARVIYGYTF	TRBV4-2	TRBJ1-2
TGCATCGGCCCAACCGCAAGGACAGGGATCGCGGCTGGCTACACCTTC	CIGPTARTGIAAGYTF	TRBV20-1	TRBJ1-2
TGTGCCAGTAGTATGAGCGAAGAGACCCAGTACTTC	CASSMSEETQYF	TRBV19	TRBJ2-5
TGTGCCCCGGGACAGGGTGTGGTCTACGAGCAGTACTTC	CAPGQGVVYEQYF	TRBV24-1	TRBJ2-7
TGCGCCAGCAGCCACCTTCCTAGTGTCACAGGGAAACCGGCCTACGAGCAGTACTTC	CASSHLPSVTGKPAYEQYF	TRBV4-3	TRBJ2-7
TGTGCCAGCAGCTTAGATCCTACTAGTGACTGGTTCTCCTACGAGCAGTACTTC	CASSLDPTSDWFSYEQYF	TRBV11-2	TRBJ2-7
TGTGCCAGCAGTTCTGGACGAGGGGCGGGCTACACCTTC	CASSSGRGAGYTF	TRBV27	TRBJ1-2
TGTGCCAGCAGCCAAGATCGCAGAACTGACACTGAAGCTTTCTTT	CASSQDRRTDTEAFF	TRBV3-1	TRBJ1-1
TGTGCCAGCAGTGGGGGAACGGTCTACGAGCAGTACTTC	CASSGGTVYEQYF	TRBV27	TRBJ2-7
TGTGCCAGCAGTGACTCGCGGACAGGTAACACTGAAGCTTTCTTT	CASSDSRTGNTEAFF	TRBV6-4	TRBJ1-1
TGTGCCAGCAGTTTCGCGACTAGCGGGGCCTGCTACGAGCAGTACTTC	CASSFATSGACYEQYF	TRBV27	TRBJ2-7
TGTGCCAGCAGCATAGACTGCAGGTCCTATAATTCACCCCTCCACTTT	CASSIDCRSYNSPLHF	TRBV9	TRBJ1-6
TGTGCCAGCAGTTTATCAACATGCCTAGCGGGCTACAATGAGCAGTTCTTC	CASSLSTCLAGYNEQFF	TRBV27	TRBJ2-1
TGTGCCAGCAGCGTAGTCATTGGGGACAACTTAACCGGGGGAGATACGCAGTATTTT	CASSVVIGDNLTGGDTQYF	TRBV9	TRBJ2-3
TGCGCCAGCAGCCAAGACGTTAGACGGGAAGGGATAATAAAAAACATTCAGTACTTC	CASSQDVRREGIIKNIQYF	TRBV4-1	TRBJ2-4
TGTGCCAGCAGCCGGGACAGTTCGTGGTCACCCCTCCACTTT	CASSRDSSWSPLHF	TRBV14	TRBJ1-6
TGTGCCAGCAGTGGGTGGACGGGGAACACTGAAGCTTTCTTT	CASSGWTGNTEAFF	TRBV6-1	TRBJ1-1
TGTGCCAGCAGTGAGGGGTTTGCAACTAATGAAAAACTGTTTTTT	CASSEGFATNEKLFF	TRBV6-4	TRBJ1-4
TGTGCCAGCCGAATGGTGAGGGGGACTAGCACAGATACGCAGTATTTT	CASRMVRGTSTDTQYF	TRBV7-9	TRBJ2-3
TGTGCCAGCAGCCCGGACGGGGGGACTGAAGCTTTCTTT	CASSPDGGTEAFF	TRBV6-2	TRBJ1-1
TGCGCCAGCCAGGGTGTTCCGACAGGGGAGCAGTACTTC	CASQGVPTGEQYF	TRBV10-1	TRBJ2-7
TGTGCCAGCAGCAGCGGGGGGGGGAACAATGAGCAGTTCTTC	CASSSGGGNNEQFF	TRBV7-2	TRBJ2-1
TGTGCCAGCAGCTTGGGAACAGGGGGCGGGGTGAACACTGAAGCTTTCTTT	CASSLGTGGGVNTEAFF	TRBV5-6	TRBJ1-1
TGTGCCAGCAGCGTAGGGCGCGGGGAATCTGAAGCTTTCTTT	CASSVGRGESEAFF	TRBV9	TRBJ1-1
TGTGCCTCCGGAGGGGCGGCCTACCGGCCTTCGGTTACTGAAGCTTTCTTT	CASGGAAYRPSVTEAFF	TRBV30	TRBJ1-1
TGTGCCAGCAATAGGGGGGGGCCCGATACGCAGTATTTT	CASNRGGPDTQYF	TRBV12-4	TRBJ2-3
TGCAGTGCTCCTTTTGGGGGGGTATACGAGCAGTACTTC	CSAPFGGVYEQYF	TRBV20-1	TRBJ2-7
TGCGCCAGCAGCCAGGGATGGCGACCATCCCACAATGAGCAGTTCTTC	CASSQGWRPSHNEQFF	TRBV5-1	TRBJ2-1
TGTGCCAGCAGGCCTCTAATAGGGCCAACTAATGAAAAACTGTTTTTT	CASRPLIGPTNEKLFF	TRBV28	TRBJ1-4
TGCGCCAGCAGCCAAGATCTTACGGGGGGGAAGTCCTACAATGAGCAGTTCTTC	CASSQDLTGGKSYNEQFF	TRBV4-1	TRBJ2-1
TGCGCCAGCAGCAAGAGGTTGGCTACTGAAGCTTTCTTT	CASSKRLATEAFF	TRBV4-1	TRBJ1-1
TGTGCCAGCAGTTACTGCAGAAATGTTCAGCCCCAGCATTTT	CASSYCRNVQPQHF	TRBV6-3	TRBJ1-5
TGCGCCAGCACGACAGGGTCCTATGGCTACACCTTC	CASTTGSYGYTF	TRBV5-1	TRBJ1-2
TGTGCCAGCAGGCGGGTACAGGGGGCGGGTAATCAGCCCCAGCATTTT	CASRRVQGAGNQPQHF	TRBV6-1	TRBJ1-5
TGTGCCAGCAGCCAACAACCAGCAGGGGATGGCTACACCTTC	CASSQQPAGDGYTF	TRBV11-2	TRBJ1-2
TGTGCCAGCAGCTTAGATCCCCGGCCTAAGGGGGGCACCGGGGAGCTGTTTTTT	CASSLDPRPKGGTGELFF	TRBV7-2	TRBJ2-2
TGTGCCAGCAGCCCTCAAGATAGGGACAACAACGCAACTAATGAAAAACTGTTTTTT	CASSPQDRDNNATNEKLFF	TRBV7-2	TRBJ1-4
TGTGCCAGCAGCTCGGGGGACCCAGCGGATGACGAGCAGTACTTC	CASSSGDPADDEQYF	TRBV7-2	TRBJ2-7
TGCAGTGCTGAGCCCGGGGTAGGAAACGTTTCCGAGCCCCAGCATTTT	CSAEPGVGNVSEPQHF	TRBV20-1	TRBJ1-5
TGTGCCAGCAGCCTTACCGATTTGGGGGGCCCTCCCCCGATTTGCTACGAGCAGTACTTC	CASSLTDLGGPPPICYEQYF	TRBV6-4	TRBJ2-7
TGTGCCAGCAGCCAAGGTCGGGGGAGTTCACCCCTCCACTTT	CASSQGRGSSPLHF	TRBV14	TRBJ1-6
TGTGCCAGCAGCTTGCCCCCAGCGGGAGGGGTTAACCCTGGGGAGTACGAGCAGTACTTC	CASSLPPAGGVNPGEYEQYF	TRBV5-4	TRBJ2-7
TGCGCCAGCAGCCAAAGTAACTTC	CASSQSNF	TRBV4-1	TRBJ2-7
TGTGCCAGCAGCGTAGTTCCCAGGAACACTGAAGCTTTCTTT	CASSVVPRNTEAFF	TRBV9	TRBJ1-1
TGTGCCACCAGCAGCTCGCTAGCGGAAGCCTTC	CATSSSLAEAF	TRBV15	TRBJ2-5
TGTGCCAGCAGTTTATCTTTCCGGGACACGACTGAAGCTTTCTTT	CASSLSFRDTTEAFF	TRBV27	TRBJ1-1
TGCGCCAGCAGCCCTCCACAAGACTACAATGAGCAGTTCTTC	CASSPPQDYNEQFF	TRBV4-1	TRBJ2-1
TGTGCTAGTGGTTGGTCAAATCTCCAGCAGTTGGGGAAGGACACTGAAGCTTTCTTT	CASGWSNLQQLGKDTEAFF	TRBV12-5	TRBJ1-1
TGCAGTGCTAGTGCAAGACAGGGGGGCGGCGGCACTGAAGCTTTCTTT	CSASARQGGGGTEAFF	TRBV20-1	TRBJ1-1
TGTGCCAGCAGTGGGGGGGGGGTACACTACGAGCAGTACTTC	CASSGGGVHYEQYF	TRBV6-3	TRBJ2-7
TGCAGTGCTAAAAAACTAGCGGGAGGGCGCCAAAACATTCAGTACTTC	CSAKKLAGGRQNIQYF	TRBV20-1	TRBJ2-4
TGCGCCAGCAGCGGGACGTGGAGCTACGAGCAGTACTTC	CASSGTWSYEQYF	TRBV5-1	TRBJ2-7
TGTGCCAGCAGCGTATCGGGCCGGGACAGGGCGTCCCTATATGGCTACACCTTC	CASSVSGRDRASLYGYTF	TRBV13	TRBJ1-2
TGTGCCAGCAGCTTGGCCCGACAGTACTATGGCTACACCTTC	CASSLARQYYGYTF	TRBV5-6	TRBJ1-2
TGCGCCAGCAGCTTGGCCTTTGAGACTAGCGAGACCCAGTACTTC	CASSLAFETSETQYF	TRBV5-1	TRBJ2-5
TGTGCCAGCAGCTTAACTAGGGAAACAACCCAGTACTTC	CASSLTRETTQYF	TRBV11-2	TRBJ2-5
TGTGCCAGCACGGCCCAGCGGGAAAAGGCTAACGAGCAGTACTTC	CASTAQREKANEQYF	TRBV13	TRBJ2-7
TGCAGTGCAAGGAGACCGACAGGGACCACAGATACGCAGTATTTT	CSARRPTGTTDTQYF	TRBV20-1	TRBJ2-3
TGCGCCAGCAGCTTGGACAGGAGCCGGGGGACGAACACCGGGGAGCTGTTTTTT	CASSLDRSRGTNTGELFF	TRBV5-1	TRBJ2-2
TGCGCCAGCAGCTCCGACAGACCCGGGGACATTCAGTACTTC	CASSSDRPGDIQYF	TRBV5-1	TRBJ2-4
TGTGCCAGCAGTAAGGAGGAATCAGATACGCAGTATTTT	CASSKEESDTQYF	TRBV6-4	TRBJ2-3
TGTGCCAGCAGTGTTGAGGGGAGCTCCTACGAGCAGTACTTC	CASSVEGSSYEQYF	TRBV6-5	TRBJ2-7
TGTGCCAACCCAGGGACTAGCGGGGGGGCGGATTTTAACACCGGGGAGCTGTTTTTT	CANPGTSGGADFNTGELFF	TRBV28	TRBJ2-2
TGTGCCAGCAGTTACCGGCTTCGTCGACACCTAGACGAGCAGTACTTC	CASSYRLRRHLDEQYF	TRBV6-3	TRBJ2-7
TGTGCCAGCAGCCTTCCGGGACTAGCGGGTTCCGAGACCCAGTACTTC	CASSLPGLAGSETQYF	TRBV6-3	TRBJ2-5
TGTGCCAGCAGTTTATGCGGGACAGGGGGCGCACAGGGGGCCAACGTCCTGACTTTC	CASSLCGTGGAQGANVLTF	TRBV28	TRBJ2-6
TGTGCCAGCAGCCAAGATTATGAGGACAGGGGCCACTATGGCTACACCTTC	CASSQDYEDRGHYGYTF	TRBV3-1	TRBJ1-2
TGTCCAGGGGTCTTTTATCCAGATACGCAGTATTTT	CPGVFYPDTQYF	TRBV10-3	TRBJ2-3
TGTGCCAGCACCCGGCTGAGCGGCACAGATACGCAGTATTTT	CASTRLSGTDTQYF	TRBV12-3	TRBJ2-3
TGTGCCAGCAGCAACTCGGGGGCAACTAATGAAAAACTGTTTTTT	CASSNSGATNEKLFF	TRBV11-2	TRBJ1-4
TGCGCCAGCAGCCAAGTACGCCGGGACACGTATGGCTACACCTTC	CASSQVRRDTYGYTF	TRBV4-3	TRBJ1-2
TGTGCCAGCACTAGGCTCACTGAAGCTTTCTTT	CASTRLTEAFF	TRBV12-3	TRBJ1-1
TGTGCCAGCAGCCCGGGGGCGCTCGGGGCCAACGTCCTGACTTTC	CASSPGALGANVLTF	TRBV7-9	TRBJ2-6
TGTGCGCTTGGACTAGCGGGCCCAATGGAGACCCAGTACTTC	CALGLAGPMETQYF	TRBV6-5	TRBJ2-5
TGTGCCAGCAGCAGCGGGAGTCTGACCGGGGAGCTGTTTTTT	CASSSGSLTGELFF	TRBV11-3	TRBJ2-2
TGTGCCTGGAGCCGGACAGGGTCCTACAATGAGCAGTTCTTC	CAWSRTGSYNEQFF	TRBV30	TRBJ2-1
TGTGCCACCAGTCCGAGGTGGACAGGGGCTGCCGGGGAGCTGTTTTTT	CATSPRWTGAAGELFF	TRBV24-1	TRBJ2-2
TGTGCCAGCAGCTTGTGGAGCAGAAGGCCCTACAATGAGCAGTTCTTC	CASSLWSRRPYNEQFF	TRBV7-3	TRBJ2-1
TGTGCCAGCACAATTGTGAGGGGGGAGAACACTGAAGCTTTCTTT	CASTIVRGENTEAFF	TRBV6-5	TRBJ1-1
TGCAGTGCTAGAGCTAGGGTATATGAGCAGTTCTTC	CSARARVYEQFF	TRBV20-1	TRBJ2-1
TGTGCCAGCTCCCCCCTAGGGTCTAGCAACATTCAGTACTTC	CASSPLGSSNIQYF	TRBV28	TRBJ2-4
TGTGCCAGCAGTGAGTCCCCTAGGGGACGGGGCGAGCAGTACTTC	CASSESPRGRGEQYF	TRBV6-1	TRBJ2-7
TGCTGGACACCGGGACAGGGCTCCTATAATTCACCCCTCCACTTT	CWTPGQGSYNSPLHF	TRBV5-1	TRBJ1-6
TGTGCCAGCAGTTCACTAATGGGGACAGGGGGGAGGGCCATTTCGGCTGGAAACACCATATATTTT	CASSSLMGTGGRAISAGNTIYF	TRBV27	TRBJ1-3
TGTGCCAGCAGCTCCACCGACCCTGGAGCTTTGAATGAGCAGTTCTTC	CASSSTDPGALNEQFF	TRBV9	TRBJ2-1
TGCAGCCCACCTACTAGGACGTGTCCCTCCTACAATGAGCAGTTCTTC	CSPPTRTCPSYNEQFF	TRBV29-1	TRBJ2-1
TGTGCCAGCTCTGGCAGACAGGGGCCCTATGGCTACACCTTC	CASSGRQGPYGYTF	TRBV25-1	TRBJ1-2
TGTGCCAGCAGCCCCCCCGGGGGGGCTCGAAACACCATATATTTT	CASSPPGGARNTIYF	TRBV7-9	TRBJ1-3
TGTGCCAGCAGCCGGGTCTGGGAGACCCAGTACTTC	CASSRVWETQYF	TRBV7-3	TRBJ2-5
TGTGCCAGTAGTATATGGGCTCGAGTTAGCTACAATGAGCAGTTCTTC	CASSIWARVSYNEQFF	TRBV19	TRBJ2-1
TGTGCCTGGAGTGCTAGCGGGTGTGCCTACAATGAGCAGTTCTTC	CAWSASGCAYNEQFF	TRBV30	TRBJ2-1
TGCAGTGCTAGAGGGGGGGTCGGGACAGGGGACACAGATACGCAGTATTTT	CSARGGVGTGDTDTQYF	TRBV20-1	TRBJ2-3
TGTGCCAGCAGCACAACAGGGACCTACGAGCAGTACTTC	CASSTTGTYEQYF	TRBV7-2	TRBJ2-7
TGTGCCTGGAGGGTTGGAAAAAGGGCCTACGAGCAGTACTTC	CAWRVGKRAYEQYF	TRBV30	TRBJ2-7
TGCAGTGCCAGGGCACCTGGGGGTGGGGGCCGAAGTTCCTACGAGCAGTACTTC	CSARAPGGGGRSSYEQYF	TRBV20-1	TRBJ2-7
TGTGCCAGCAGCACAGTCCCAAGGCGGGCAACTAATGAAAAACTGTTTTTT	CASSTVPRRATNEKLFF	TRBV11-3	TRBJ1-4
TGCAGTGCTAGGGCCAGGGACGGGTTGAGTGATGAGCAGTTCTTC	CSARARDGLSDEQFF	TRBV20-1	TRBJ2-1
TGTGCCAGCAGTGAATCATGTCGGACTAGGGCTAGCTCCTACAATGAGCAGTTCTTC	CASSESCRTRASSYNEQFF	TRBV25-1	TRBJ2-1
TGTGCCAGTAGTATAGCCTGGACTAGCGGGAGCTTTTTCGGGCGAAAGAACACTGAAGCTTTCTTT	CASSIAWTSGSFFGRKNTEAFF	TRBV19	TRBJ1-1
TGTGCCAGCAGCTCACTAGGCTCCCAAGAGACCCAGTACTTC	CASSSLGSQETQYF	TRBV11-3	TRBJ2-5
TGTGCCAGCAGTTCTCGGACGAGCTATGGCTACACCTTC	CASSSRTSYGYTF	TRBV27	TRBJ1-2
TGTGCCACGTTCGGGAGGGCCCTGGGGAACACTGAAGCTTTCTTT	CATFGRALGNTEAFF	TRBV24-1	TRBJ1-1
TGTGCCACCGATCCCCCTAGGGAACAAAGGTCCTACGAGCAGTACTTC	CATDPPREQRSYEQYF	TRBV24-1	TRBJ2-7
TGCGCCAGCAGTGAAGGTAAACTGGGATTCTTGCGCCAGCCCCAGCATTTT	CASSEGKLGFLRQPQHF	TRBV10-1	TRBJ1-5
TGTGCCAGCAGCTGGACAGTGGTAAGAGGGAAAACTGAGGTAGAGACCCAGTACTTC	CASSWTVVRGKTEVETQYF	TRBV7-6	TRBJ2-5
TGTGCCAGCATCATCGGCGGGAGGGTTTGCAATCAGCCCCAGCATTTT	CASIIGGRVCNQPQHF	TRBV6-4	TRBJ1-5
TGTGCCAGCAGCTTAGTAAACAGGGAAGGACTCGAGCAGTACTTC	CASSLVNREGLEQYF	TRBV7-4	TRBJ2-7
TGTGCCAGCAGCTTGGGGGGTCGACCTAGCGGGGACTACAATGAGCAGTTCTTC	CASSLGGRPSGDYNEQFF	TRBV5-4	TRBJ2-1
TGTGCCTATGCCAGAAGGTTGGTCAGACAGCCCCAGCATTTT	CAYARRLVRQPQHF	TRBV28	TRBJ1-5
TGTGCCAGCAGTTTCCAGCAGGGTCTCCAGGGGAAGCCCCAGCATTTT	CASSFQQGLQGKPQHF	TRBV27	TRBJ1-5
TGTGCCAGCAGTTTAACCGGGGAAGACAATGAGCAGTTCTTC	CASSLTGEDNEQFF	TRBV12-3	TRBJ2-1
TGTGCCAGCAGCGTAGCCTCCCCCAACAGGGGGCAAGCTTTCTTT	CASSVASPNRGQAFF	TRBV9	TRBJ1-1
TGTGCCGGGCGTCTACACCAAGAGACCCAGTACTTC	CAGRLHQETQYF	TRBV11-2	TRBJ2-5
TGTGCCAGCAGCAATACCCCTAAGACCTACGAGCAGTACTTC	CASSNTPKTYEQYF	TRBV7-3	TRBJ2-7
TGTGCCAGCAGTGACTCACCCATGACGTACGAGCAGTACTTC	CASSDSPMTYEQYF	TRBV6-4	TRBJ2-7
TGTGCCAGCAGCGTTGCGGATGTCTCTGGGGCCAACGTCCTGACTTTC	CASSVADVSGANVLTF	TRBV9	TRBJ2-6
TGTGCCAGCTCACCCGGGGGGTTAGCGGTTGAAAAACTGTTTTTT	CASSPGGLAVEKLFF	TRBV18	TRBJ1-4
TGTGCCAGCAGTTCATGCCTGCCACCAGGCCGGGGAAACACCGGGGAGCTGTTTTTT	CASSSCLPPGRGNTGELFF	TRBV12-3	TRBJ2-2
TGTGCCAGCACCGTTATTCTGGCGTTGCCCGGCGAGCAGTACTTC	CASTVILALPGEQYF	TRBV27	TRBJ2-7
TGTGCCAGCAGCTTGAGGACCCCCGAATATCGGAGCTACGAGCAGTACTTC	CASSLRTPEYRSYEQYF	TRBV7-3	TRBJ2-7
TGTGCCAGCAGCTTATCGAATAGGTTAGGACAGGAGGGGGTACTCTACGAGCAGTACTTC	CASSLSNRLGQEGVLYEQYF	TRBV11-3	TRBJ2-7
TGTGCCAGCAGCTGGGTCCGGGACAGGGCGGGGAGGGGCAATCAGCCCCAGCATTTT	CASSWVRDRAGRGNQPQHF	TRBV5-6	TRBJ1-5
TGTGCCAGCAGGGAAATTAGAGGGACGAATGACGAGCAGTACTTC	CASREIRGTNDEQYF	TRBV6-5	TRBJ2-7
TGCGCCAGCAGCTATCACAGGGGGATCCTGGGAAACACTGAAGCTTTCTTT	CASSYHRGILGNTEAFF	TRBV5-1	TRBJ1-1
TGTGCCAGCAGCTTAAAGACCAGAGAACCAGGGGAAGTGCCTACCGGGGAGCTGTTTTTT	CASSLKTREPGEVPTGELFF	TRBV7-3	TRBJ2-2
TGTGCCAGCAGTTTTCCGACAGGTTATGGCTACACCTTC	CASSFPTGYGYTF	TRBV12-4	TRBJ1-2
TGTGCCACCAGTGAGACCAGGGAGGGGGGGGAGGGGAACTCTGGGGCCAACGTCCTGACTTTC	CATSETREGGEGNSGANVLTF	TRBV24-1	TRBJ2-6
TGCGCCAGCAGCCGCCTCTTAAGCACGCGCGAGCAGTACTTC	CASSRLLSTREQYF	TRBV4-3	TRBJ2-7
TGCAGTGCTAGAGGTCTAGCGGGGGTGGATACGCAGTATTTT	CSARGLAGVDTQYF	TRBV20-1	TRBJ2-3
TGTGCCAGCAGTTTATCGACCTCCAGGACTAGCGGGAGGGGCGGGTACACTGAAGCTTTCTTT	CASSLSTSRTSGRGGYTEAFF	TRBV27	TRBJ1-1
TGTGCCAGCAGCTTAAGAGTCCCCTACGAGCAGTACTTC	CASSLRVPYEQYF	TRBV7-9	TRBJ2-7
TGTGCCAGCAGCTTCCGGGACAACTCTGGGGCCAACGTCCTGACTTTC	CASSFRDNSGANVLTF	TRBV7-9	TRBJ2-6
TGTGCCAGCAGCCAAGGATGGCGCACAGATACGCAGTATTTT	CASSQGWRTDTQYF	TRBV4-2	TRBJ2-3
TGTGCCAGCAGCAGCTCCCGGGACAGACTGGGGGGGGGTAGGAGCGAGCAGTACTTC	CASSSSRDRLGGGRSEQYF	TRBV3-1	TRBJ2-7
TGTGCCAGCAGCAAAGGAAGGGACGAGCAGTACTTC	CASSKGRDEQYF	TRBV7-2	TRBJ2-7
TGTGCCAGCAGCTGGATTCCCCAGGAGCGCACTGAAGCTTTCTTT	CASSWIPQERTEAFF	TRBV13	TRBJ1-1
TGTGCCAGCAGCATTCAGTCGGGCAATCAGCCCCAGCATTTT	CASSIQSGNQPQHF	TRBV6-1	TRBJ1-5
TGTGCCAGCAGTTACTTGCCAGGCGGGCGGGGGTCGGCCGCCCAGCATTTT	CASSYLPGGRGSAAQHF	TRBV6-5	TRBJ1-5
TGTGCCAGCAGCTTAATTAGACAGGCCTGGATTTGGCAGTACTTC	CASSLIRQAWIWQYF	TRBV7-9	TRBJ2-7
TGCGCCAGCTTTCTAGCGGGGTATTTT	CASFLAGYF	TRBV5-1	TRBJ2-3
TGCAGCGTTGAAGTCGCACAGGGTAGCCCCTACGAGCAGTACTTC	CSVEVAQGSPYEQYF	TRBV29-1	TRBJ2-7
TGTGCCAGCATTACGGGGGGGGTGGGCTATGGCTACACCTTC	CASITGGVGYGYTF	TRBV9	TRBJ1-2
TGTGCCAGCAGGGACTCGGGGGGCTGGGCTAACTATGGCTACACCTTC	CASRDSGGWANYGYTF	TRBV12-3	TRBJ1-2
TGTGCCAGCAGCTCCAGGACTAGCGGGGGGGTTGTCTACAATGAGCAGTTCTTC	CASSSRTSGGVVYNEQFF	TRBV7-9	TRBJ2-1
TGTGCCAGCAGCTTGGCCATATCAAGGCGTCTTGGAAACACCATATATTTT	CASSLAISRRLGNTIYF	TRBV5-4	TRBJ1-3
TGTGTATGCGGGACAGGGGGCCGTTCCGGGGACACAGATACGCAGTATTTT	CVCGTGGRSGDTDTQYF	TRBV5-4	TRBJ2-3
TGTGCCAGCAGCCCGCTCGGCGATGGCTACACCTTC	CASSPLGDGYTF	TRBV6-6	TRBJ1-2
TGTGCCAGCAGCTTTAAGTGGGTGGGGTACGAGCAGTACTTC	CASSFKWVGYEQYF	TRBV7-9	TRBJ2-7
TGTGCCAGCAGCTCAATTAAAGGGGAGGTTTCCAGGGCTAATGAAAAACTGTTTTTT	CASSSIKGEVSRANEKLFF	TRBV6-2	TRBJ1-4
TGTGCCAGTAGTAGTTGGAGTTGTGGGGGTCGGGGCTACACCTTC	CASSSWSCGGRGYTF	TRBV19	TRBJ1-2
TGTGCCAGCAGCTACATAGCGGGGGCCTACAATGAGCAGTTCTTC	CASSYIAGAYNEQFF	TRBV7-4	TRBJ2-1
TGTGCCATCACCGGGGACGCCGGCTACACCTTC	CAITGDAGYTF	TRBV10-3	TRBJ1-2
TGTGCCAGCAGTTTATGCGTGGGAGTCCAGCCCCAGCATTTT	CASSLCVGVQPQHF	TRBV27	TRBJ1-5
TGTGCCCCGGGGGGCCGATATAGCAATCAGCCCCAGCATTTT	CAPGGRYSNQPQHF	TRBV7-2	TRBJ1-5
TGTGCCAGCAGCCTGGGTCTAGGAAACGAGCAGTACTTC	CASSLGLGNEQYF	TRBV14	TRBJ2-7
TGTGCCACGGACAGGGGGCGTCAAGAGACCCAGTACTTC	CATDRGRQETQYF	TRBV24-1	TRBJ2-5
TGTGCTAGTGGTTTGGTAAGGATAGACTACAATGAGCAGTTCTTC	CASGLVRIDYNEQFF	TRBV12-5	TRBJ2-1
TGTGCCACCAGTGATTTGCCACAGGAATCCTCTGGAAACACCATATATTTT	CATSDLPQESSGNTIYF	TRBV24-1	TRBJ1-3
TGTGCCAGCAGCCCAGAGCGAACCCAGCATTTT	CASSPERTQHF	TRBV13	TRBJ1-5
TGTGCCAGCATCAAAGGGGCGTCTGGAAACACCATATATTTT	CASIKGASGNTIYF	TRBV7-2	TRBJ1-3
TGTGCCCGCCGGGACAGGGGAAGAGACATTCAGTACTTC	CARRDRGRDIQYF	TRBV6-5	TRBJ2-4
TGTGCCAGCAGCTTACTAGGGCTCGCTGGCTACACCTTC	CASSLLGLAGYTF	TRBV7-6	TRBJ1-2
TGTGCCAGCAGCTGTCCAAAAGGGCTTTTTTTTGCCCAGCATTTT	CASSCPKGLFFAQHF	TRBV5-6	TRBJ1-5
TGTGCCAGCAAAGCCGACAGGACCCAAGAGACCCAGTACTTC	CASKADRTQETQYF	TRBV7-8	TRBJ2-5
TGTGCCACCAGTGAGCAACCAGGATATCAGCCCCAGCATTTT	CATSEQPGYQPQHF	TRBV24-1	TRBJ1-5
TGCGCCAGCAGCCAAGATCCGGGACTAGCGGAGGATTGGACGACCGGGGAGCTGTTTTTT	CASSQDPGLAEDWTTGELFF	TRBV4-1	TRBJ2-2
TGCGCCAGCAGCTTCACCTCGCGCGTGGCTTCCACAGATACGCAGTATTTT	CASSFTSRVASTDTQYF	TRBV5-1	TRBJ2-3
TGTGCCAGCAGTTACTCGGAGCAAGAGACCCAGTACTTC	CASSYSEQETQYF	TRBV6-5	TRBJ2-5
TGTGCCACCAGGACAGGGCTCTATGGCTACACCTTC	CATRTGLYGYTF	TRBV24-1	TRBJ1-2
TGTGCCACCAGTGGTCTTCTAGCGGGAGCCTACGAGCAGTACTTC	CATSGLLAGAYEQYF	TRBV24-1	TRBJ2-7
TGTGCCAGCCTCGAGAAGGGGGCAGATACGCAGTATTTT	CASLEKGADTQYF	TRBV2	TRBJ2-3
TGTGCCAGCAGCCGAGTAGTTGGGGGGCGCGAGCAGTACTTC	CASSRVVGGREQYF	TRBV11-3	TRBJ2-7
TGTGCCACCAGTGATTGGCCCGACCGAGTCTACGAGCAGTACTTC	CATSDWPDRVYEQYF	TRBV24-1	TRBJ2-7
TGTGCCACCAGTGTTCCGGGACAGGGGTTAAGCTCCTACAATGAGCAGTTCTTC	CATSVPGQGLSSYNEQFF	TRBV24-1	TRBJ2-1
TGCAGTGCTAGAGATAGACGTGCTGAATCAGGGTTGGACCAGGCCAGTACAGATACGCAGTATTTT	CSARDRRAESGLDQASTDTQYF	TRBV20-1	TRBJ2-3
TGTGCCAGCAGCTTGGTCTCGACAGGGAAGGGAACCGGGGAGCTGTTTTTT	CASSLVSTGKGTGELFF	TRBV5-6	TRBJ2-2
TGTGCCAGCTCACCAAATAACAATGAGCAGTTCTTC	CASSPNNNEQFF	TRBV18	TRBJ2-1
TGTGCCAGCAGCCAAGAAGACTCACCGGGGGGGGGAACCGGAGATACGCAGTATTTT	CASSQEDSPGGGTGDTQYF	TRBV14	TRBJ2-3
TGTGCCAGCAGCGTACAGGGAAAGAGACCCTACGAGCAGTACTTC	CASSVQGKRPYEQYF	TRBV7-3	TRBJ2-7
TGTGCCACCAAAGGTGGGAAGCGGTATGGCTACACCTTC	CATKGGKRYGYTF	TRBV24-1	TRBJ1-2
TGTGCCAGCAGACCTGGCGGGTTCCCACGCTGCGGCTACGAGCAGTACTTC	CASRPGGFPRCGYEQYF	TRBV6-4	TRBJ2-7
